5A03JGN00-ATM4614P06QA2201
1
4213
337
70
65
PPPPPPPPFF***FF***FFPPPPPPPPPPPPPPPPPPPPPPPPPPPPPPPPPPPPPPPPPPPPPPPPPP
PPPPPPPPPPPPPPPPPPPPPPPPPPPPPPPPPFPPPFPPPPPPPPPFPPPPPPPFPPPPPPPPPPPPPP
PPPPPPPPPPPPFPPPPPPPPPPPPPPPPPPPPPPPPPPPPPPPPPPPPPPPPPPPPPPPPPPPPPPPPP
PPPPPPPPFPPPPPPPPPPPPPPPPPPFPPPPPPPPPPPPPPPPPPPPPPPPPPPPPPPPPPPPPPPPPP
PPPFPPPPPPFPPPPPPPFPPPPPPPPFPPPPPPPPPPPPPPFPPPPPPPPFFPPPPPPPPPPPPPPPPF
PPPFFPPPPPPPPPPPPPPPPPPPPPPPPPPFPFPPPPPPPPPPPPPFPFPPPPPPPPPFPPPPPPPPPP
PPPFPPPPPPPFPPPPPPPPPPPPPPPPPPPPPPPPPPPPPPFPPPPPPPPPPPPPPPPPPPFPPPPPPP
PPPPPPPPPPPPPPPPPPPPPPPPPPPPFPPPPPPPFPPPPPPPPPPPPPPPPPPPPPPPPPPPPPPPPP
PPPPPPPPPPPPPPPPPPPPPPPPPPPPPPPPPPFPPPPPPPPPPPPPPPPPPPPFPPPPPPPPPPPPPP
PPPPPPPFPPFPPPPFFPPPPFFPPPPFPPPPFPPPPPPPPPPPPPPPPPPPPPPPPPPPPFPPPPFPPP
PPPPPPPPPPPPPPPFFPPPPPPPPPPPPPPPPPPPPPPPPPPPPPPPPPPPPPPPPPPPPPPPPPFPPP
PPPPPPPPPPPPPPPPPPPPPPPPPPPPPPPPFFPPPPPPPPPPPPPPPPPPPPPPPPPPPPFPPPPFPP
PPPPPPPPPPPPPPPPPPPPPPPPPPPPPPPPPPPFPPPPPPFPPPPPPPPPPFPPPPPPPPPPPPPPPP
PPPPPPPPPPPPPPPPFPFPFFPPPPPPPPFPPPPPPPPPPPPPPPPPPPPFPPFFPPFPFFPPPPPPPP
PPPFPPPPPPPPFPPPPPPPPPFPPPPPPPFPPFPPPPPPPPPPPFPPPPPFPPPPPFPPPPPPPPPFPP
PPPPFPPPPPPPPPPPPPPPPPPPPPPPPPPPPFPFFPPPPPPPPPPPPPPPFPPFPPPPFFPPPPPPPP
PPPPPPPPPPPPPPPFPPPPPPPPFPPPPPPFPPPPFPPPPPPPPPPPPPPPFPPPPPPPPFPPPPPPFP
PPPPPPPPPPPPPPPPPFFPPPPPPPPPPPPPPPPFFPPPPPFFFFPPPPPPPPPPPPPPPFFPPFPPPP
PPPPPPFFPPPPPPPPFFFPPPPPFPPFPPPPPPPPPPPPPPPPFPPFPPPPPPPPPPPPPPPPPFPPPF
PPPPPPPPPPPPPPPPPPPPPPPPPPPFPPPPPPPPPPPPPPPPPPPPPPPPPPPPPPPPPPFPPPPPFP
PPPPPPPPPPPPPPPPPPPPPPPFPPPPPPPPPPPPPPPPPPPPFFPPPPPPPPPPPPPPPPPPPPPPPP
PPPPPPPPPPPPPPPPPPPPPPPPFFPPFFPPPPPPPPPPPPPPPPPPPPPPPPPPPPPPPPPPPPPPPP
PPPPPPPPPPPPPPPPPFPPPPPPPPFFPPPPPPPPFFPPPPFPPFPPPPFPPPPPPPPFPPPPPPPPPP
PPPPFPPPPPPPPPPPPPPPPPFPPPPPPPPFPPPPPPFFPPPPPPPPFPPPPPPPPPPPPPPPPPPPPP
PPPPPPFPPPPPPPPFPPFFPPPPPPPPPPFPPPPPPPPPPPPPFPPPPPPPPPPPPPPPPPPPPPFPPP
PPPPPPPPPPPPPPPPPPPPPPPFPPFPPFPFFPPPPPFFPPPPPPPPPPPPPPPPFPPPPPPPPPPPPP
PPPPPPPPPPPPPPPPPPPPPPFFPPPPPPPPPPPPPPPPPPPPPPPPPPPPPPPPPPPPPPPPPPPPFP
PPPPFPFPPPPPPPPPPPPPPPPFPPPPPPPPPFPFPPPPPFPPPPPPPPPPPFPPFPPPPPFPPPPPFP
PPPPPPPPPPPPPPPPPPPPPPPPFPPPFFPPPPPPPPPFFPPPPPPPPPPPPPPPPPPPPPPPPPPPPP
PPPPFPPPPFFPPPPPFPPPPPPPPPPPPPFPFPPPPPPPPPPPPPPPPPPPPPPPPPPPPPPPPPPPPP
PPPPPPPPPPPPPPPFPPPPPPPFFFPPPPPPPPPPPPPFPPPFPPPPPPFPPPPPPPPPPPPPPPPPPP
PPPPPPFPPPPPPPPPPPPPPPPPPPPPPPPPPPPPPPPPPPPPPFPPPPPPPPFPPPPPPPPPPPPPPP
PPPPPPPPPPPPPPPPPPPPPPPPPPPPPPPPFPPPPPFFPPPPPPPPPPPPPPPPPPPPPPPPPPPFPP
PPPPPPPPPPPPPPPPPPPPPPPPPFPPPPPPFPPPFFPPPPPPPPPPPPFFPPPPPPPPPPPPPPPPPP
PPPPPPPPPPPPPPPPPPPPPPPPPPPPPPPFPPPPPPPPPFFPPPPPPPPPPPPPPPFFPPPPPPPPPF
PPPPPPPPPPPPPPPPPPPPPPFPPPPPPPPFPFPPPPPPPPPPPPPPPPPPPFPPPPPPPPPPPPPPPP
PPPPPPFPPPPPPPPPPPPPPPPPPPPPPPPPPPPFFPFFPPPPPPPFFPPFPPPPPPPPPPPPPPPPPP
PPPPPPPPPPPPPPFPPPPPPPPPPPPPPPPPPPPPPPPPPPPPPPPPPPPPPPPPPPPPPPFFPPPPPP
PPPPPPPPPPPPPPPPFFPPPPPPFPPPPPPPPPPPFFPPPPPPPPPPPPPPPPPPPPPPPPFFPPPPPP
PPPPPPPPPPPPPFPPPPPPPPPPPPPFPPPFPPPPPPPPPPPPPPPFFPPPPPPPPPPPPPPPPPPPPP
PPPPPPPPPPPPPPPPPPPPPPPPPPPPPPFPPPPFFPPPPPPPPPFPPPPPPFFFPPPPPPPPPPPPPP
PPPPPPPFPPPPPPPPPPPPPPPPPPPPPPPPPFFPPPPPPPPPPPPPPPPPPPPPPPPPPPPPPPPPPP
PPPPPPPPPPFPPFPPPPPPPPPPPPPPPPPPPPPPPPPPFFPPPPPPPPPPPPPPPPPPFPPPPPPPPP
FPFPPPPPPPPPFFPPPPPPFPPPPPPPPPPPPPPPPPPPFPPPFFPPPPPPPPPPPFPPPPFPPPFFFF
PPPPPPPPPPPPPPPPPPPPPFPPPPPPPPFPPPFFPPPPFPPPPPPPPPFFPPPPPFPFPPPPPPPPPP
PPPPPPPPPPPPPPFFFPPPPPPPPPPPPPPPPPPPPPPPPPPPPPPPPPPPPPPPPPPPPPPPPPFPPP
PPPPPPPPPPPPPPPPPPPPPPPPPPPPPPPPPPPPPPPPPPPPPPPPPPPPPPPPPPPPPPPPPPPPPP
PPPPPPPPPPPPPPPPPPPPPPPPPPPPPPPPPPPPPPPPPPPPPPPPPPPPPPPPPPPPPPPPPPPPPP
PPPPPPPPPPPPPPPPPPPPPPFPPPPPFPPPPPPPPPPPPPPPPPPPPPPFFPPPPPPPPPPPPPPPPP
FPPPPPPPPPPPPPPFPPPPPPPPPPPPFPPPPPPPPPPPPPPPPPPPPPPPPFPPPPPPPPPPPPPPPP
PPPPPPPFPPPPPPPPPPPPPPPPPPPPPPPPPPPPPPPPPPPPPPPPPPPPPPPPPFPPPPPPPPPPPP
PPPPPPPPPPFPPPPPPPPPPPPPPPPPPPPPPPPPPPPPPPPPPPPPPPPPPPPPPPPPPPPPPPPPPP
PPPPPPPPPPPPPPPPPPPPPPPPPPPPPPPPPPPPPPPPPPPFPPPPPPPPPPPPPPPFPPPPPPPPPP
PPPPPPPPPPPPPPPPPPPPPPPPPPPPPPPPPPPPPPPPPPPPPPPPPPPPPPPPPPPPPPPPPPPPPP
PPPPPPPPPPPPPPPPPPPPPPPPFPPPPFPPPPPPPPPPPPPPPPPPPPPPPPPPPPPPPPPPPPPPPP
PPPPFPPPPPPPPPPPPPPPPPPPPPPPPPFPPPPFPPPPPFPPPPPPPPPPPPPFPPPPPPPPPPPPPP
PPPPPPPPPPPPPPPPPPPPPPPPPPPPPPPFPPPPPPPPPPPPPPFPFFPPPPPPPPPPPPPPPPPPPP
PPPPPPPPPPPPPPPPPPPPPPPPPPPPPPPPPPFFPPPPFPPPPPPPPPPPPPPPPPPPPPPPPPPPPP
PPPPPPPPPPPPPFFPPPPPPPPPPPPPPPPPPPPPPPPPPPPPPPPPPPPPPPPPPPPPPPPFPPPPPP
PPPPPPPPPPPFPPPPPPPPPPPPPPPPPPPPPPPPPPPPPPPPPPPPPPPPPPPPPPPPFPPPPPPPPP
PPPPPPPPPPFFPPPPPPPPPPPPPPPPPPPPPPPPPPPPPPPPPPPPPPPFPPPPPPPPPPPFPPPPPP
PPPPPPPPPPPPPPPPPPPPPPPPPPPPPPPPPPPPPFPPPPPPPPPPPPPPPPPPPPPPPPPPPPPPPP
PPPPPPPPPPPPPPFPPPPPPPPPPPPPPPPPPPPPPPPPPPPPPPPFFPPPPPPPPPPPPPPPPPPPPP
PPPPPPPPPPPPPPPPFFPPPPPPPPPPPPPPFPPPPPPPPPPPPPPPPPPPPPPPPPPPPPPPPPPPPP
PPFFPPP*******F***FFPPPPPPPPPPPPPPPPPPPPFPPPPPPPPPPPPPPPPPPPPPPPPPPPPP
5A03JGN00-ATM4614P06QA2201
2
4214
336
70
65
PPPPPPPPPPPPPPPPPPPPPPPPPPPPPPPPPPPPPPPPPPPPPPPFFPPPPPPPPPPFFPPPPPPPPP
PFPPPFPPPPPPPPPPPPPPPPPPPPPPPPPPPPPPPPFFPPPPPPPPPFPFFPPPPPPPPPPPPPPPPP
PPPPPPPPPPPPPPPPPPPPPPPPPPPPPPPPFFPPPPPPPPFFPPPPPPPPPFFPFFPPPPPPPPPPFP
PPPPPPPPPPPPPPPPPPPPPPPPPPPPPPPPPPPPPPPPPPPPPPPPPPPPPPPPPPFPPPPPPPPPPP
PPPPPPPPPPPPPFFPPPPPPPPPPPFPPPPFPPPPPPFPPPPPPPPPPPPPPPPPPPPPPPPPPPPPPP
PPPPPPFPPPPPPPPPPPPPPPPPPPPPPPFFPPPPPPPPPPPPPPPPPPPPPPPPPPPPPPFPPPPPPP
PPPFFPPPPPPPPPPPPPPPFPPPPPPPPFPPPPPPPPPPPPPPPPPPPPPPPPPPPPPPPPPPPPPPPP
PPPPPPPPPPPFFPPPPPPPPPPPPPPPPPPPPPPPPPPPPPPPPPPPPPPPPPPPPPPPPPPPPPPPPP
PPPPPPPPPPPPPPPPPPPPFPPFPPPPPPPPPPPPPPPPPPPPPPPPPPPPPPPPPPPPPPPPPPPPPP
PPPPPPPPPPPPPPPPPPPPPPFPPPPPPPPPPPPPPPPPPPPPPPPPPPPPPPPPPPPPPPPPPPPPPP
PPPPPPPPPPPPPPPPPPPPPPPPPPPPPPPPPPPPFFPFFPPPPPPPPPPPPPFPPPFPPPPPPPPPPP
PPPPPFPPPFFPPPPPPPPPPPPPPPPPPPPPPPPPPPPPPPPFPPPPFPPPPPPPPPPPPPPPPPPPPP
PPPPPPPPFFPPPPPPPPPPPPPPPPPPPPPPPPPPPPPPPPPPPPP*P*PPPPPPFPFPFFPPPPPPPP
PPPPPPPPPPPPPPPPPFPPPPPPPPPPPPPPPPPPPPPPPPPPPPPPPFFPPFPPPPPPPFFPPPPPPF
FFFFFFFFFF***FF***FFFFFFFFFFFFFFFFFFFFFFFFFFFFFFFFFFFFFFFFFFFFFFFFFFFF
PPPPPPPPPFFPPFPPPPPFFPPPPPPPPPPPPPPPPPPPPPPPPPPPPPPPPPPFFFPPPPPPPPPPPP
PPPPPPPPPPPPPPPPPPPPPPPPPFPPPPPPPPPPPPPPPPPPPPPPPPPPPPPPPPPPPPFPPFPPPP
PPFPPPPPPPPPPPPPFPPPPFFFPPPPPPPPPPFPPPFPPPPPPPPPPPPPPPPPPPPPPPPPPPPPPP
PPPPPPPPPFPPPPPPPPPPPPPPPFFPPPPPFFPPPPPPPPPPFPPPPPPFPPPPPPPPPPPPPPPPPP
PPPPPPPPPPPPPPPPPPPPPPPPPPPPPPPPPPPPPPPPPPPPPPPPPPPPPPPPPPFPPPPPPPPPPP
PFPPPFFPPPPPFPPPPPPPPPPPFPPPPPFPFPPPPPPPPPPPPPPPPPPPPPPPPPPPPPPPPPPPPP
PPPPPPPPPPPPPPPPPPPPPPPPPFFPPPPPPPPPPPPPPPPPPPPPPPPPPPPPPPPPPPPPPPPPPP
PPPPPPPPPPFFPPPPPPPFPPPPPPPPPPPPPPPPPPPPPPPPPPPPFPPPPPPPPPPPPFPPPPPPPP
PPPPPPPPPPPFPPPPPPPFFPPPPPPPPPPPPPPPPPPPPPPPPPPPPPPPPPPPPPPPPPPPPPPPPP
PPPPPPPPPPPPPPPPPPPPPPPPFFPPPPPPPPPPPPPPPPPPPPPPPFPPPPPPPPFFPPPPPPPPPP
PFFPPPPPPPPPPPPPPPPPPPPPPPPPPFPPPPPPPPPPPPPPPPPPFFPPPPPPPFFPPPPPPPPPFF
PPPPPPPPPPPPPPPPPPPPFFPPPPPPPPPPPPPPPPPPPPPPPPPPPPPPPPPPPPPPPPPPPPFFPP
PPPFPPPPPPPFFPPPPFFPPPPPPPPPPPPPPPPPPPPPPPPPPPPPFPPFPPPPFFPPPPPPPPPPPP
PPPPPPFPPPPPPPPPPPFPPPPPPPPPPPPPPPPPPPPPPPPPPPPPPPPPPPPPPPFPPPPPPPPPPF
PPPPPPPPPPPPFPPPPPPPPPPPPPPPPPPPPPPPPPPPPPPPPPPPPPPFFPPPPPPPPPPPPPPPPP
PPPPPPFPPPPPPPPPPPPPPPPPPPPPPPPPPPPPPPPPPPPPPPPPPPPPPPPPPPPPPPPPPPPPPP
PPPPPPPPPPPPPPPPPPPPPPPPPPPPPPPPPPPPPPPPPPPPPPPPPPPPPPPPPPPFPPPPPPPPPP
PPPPPPPPPPPPPPPPPPPPPPPPFPPPPPFPPPPPPPPPPPPPFPPPPPPPPPPPPPFPPFFFFPPPPP
PPPPPPPPPPPPPPPPPPPPPPPPPPPPPPPPPPPPPPPPPPPPPPPPPPPPPPPPPPPPPPPPPPFPPP
PPFPPPPPPPPPPPPPPPPPPPPPPPPPPPPPPPPPPPPPPPPPPPFPPPPPPPPPPPPPPPPPPPPPPP
PPPPPPPPPPPPPPPPPPPPPPPPPPPPPPPPPPPPPPPPPPPPPPPPPPPPPPPPPPPPPPPPPPPPPP
PPPPPPPPPPPPPPPPPPPPPPPPPPPPPPPPPPPFFPPPPPPPPPPFFPPFPPPPPPPPPPPPPPPPPP
PPPPPPPPPPPPFFFPPPPPPPPPPPPPPPPPPPPPPPPPPPPPPPPPPPPPPPPPPPPPPPPPPPPPPP
PPPPPPPPPPPPPPPPPPPPPPPPPPPPPPPPFPPPPPPPPPPPPPPPPPPPPPPPPPPPPPPPPPPPPP
PPPPPPPPPPPPPPPPPPPPFFPPPPPPPPPPPPPPPPPPFPPPPPPPPPPPPPPPPPPPPPPPPPPPPP
PPPPPPPPPPPPPPPPPPPPPPPPPPPPPPPPPPPPPPFFFPPPPPPPPPPPPPPPPPPPPPPPPPPPPP
PPPPPPPPPPPPPPPPPPPPPPPPPPPPPPPPPFFPPPPPFPPPPPFFFPPPPPPPPPPPPPPFFPPPPP
PPPPPPPPPPPPPPPPPFPFPPPPPPPPPPPPPPPPPPPPFPPPPPPPPPPPPPPPPPPFPPPPPPFPPP
PPPPPPPPPPPPPPPPPPPPFPPPPPPPPPPPPPPPPPPFFFFPPPPPPPPPPPPPPPPPPPPPPPPPPP
PPPPPPPPPPPPPPPPPPPPPPPPPPPPPPPPPPPPPPPPPPPPPPFFPPPPPPPPPPPPPPPPPPPPPP
FPPPPPPPPPPPPPPPPPPPPPPPPPPPPPPPPPPPPPPPPPPPPPPPPPFPPPPFFPPPPPPPPPPPPP
PPPPPFPPPPPPPPPPPFPPPPPPPPPPPPPPPPPPPPPPFPPPPPPPPPPPPPFPPPPFFPPPPPPPFF
PPPPPPPPPPPPPPPPPPPPPPPPPPPPPPPPPPPPPPPPPPPPPPPPPPPPPPPPPPPPPPPPPPFFPP
PPPPPPPPPPPPPPPPPPPPPPFPPPPPPPPPPPPPPPFPPPPPPPPPPPPPPPPPPPPPPPPPPPPPPP
PPPPPPPPPPPPPPPPPPPPPPPPPPPPPPPPPPPPPPPPPPPPPPPFPPFPPPPPPPPPPPPPPPPPPP
PPPPPPPPPPPPFPPPPPPPPPPPPPPPPPPPPPPPPPPPPPPPPFPPPPPPPPPPPPPPPPPPPPFPPP
PPPPPPPPPPPPPPPPPPPPPPPPPPPPPPPPPPPPPPPPPPPPFPPPPPPPPPPPPPFPFPPPPPPPPP
PPPPPPPPPPPPPPPPPPPPPPPPPPPPPPPPPPPPPPPPPPPPPPPPPPFPPPPPPPPPPPPPPPPPPP
PPPPPPPPPPPPPPPPPPPPPPPPPPPPPPPPPFPPPPPPPPPPPPPPPPPPPPPPPPPPPPPPPPPPPP
PFPPPPPPFFPFPPPPPPPPPPFFPPPPPPFPPPPPPPPPPPPPPPPFPPPPPPPPPPPPPPPPPPPPPP
PPPPPPPPPPPPPPPPPPPPPPPPPPPPPPPPPPPPPPPPPPPPPPPPPPPFPPPPPPPPPPPPPPPPPP
PPPPPPPPPPPPPPPFPPFPPPPPPPPPPFFPPPPPPPPFPPPPPPPPPPPPPPPPPPPPPPPPPPPPPP
PPPPPPPPPPPPPPPPPPPFPPPPPPPPPPPPPPPPPPPPFPPPPPPPPPPPPPPPPPPPPPPPPFPPPF
PPPFPPPPPPPPPPPPPPPPPPPPPPPPPPPPPPPPPFPPPPPPPPPPPPPPPPPPPPPPPPPPPPPPPP
PPPPPPPPPPPPPPPPPPPPPFFPPPPPPPPPPPPPFPPFPPFPPFPFPPPPPFPPPPPPPPPPPPPPPP
PPPPPPPPFFPPPPPPPPPPPPPPPPPFFPPPPPPPPPPPPPPPPPPPPPPPPPPPPPPFPPPPPPPPPP
PPPPPPPPPPPPPPPPPPFFPPPPPPPPPPPPPFPPPPPPPPPPPPPPPPPPPPPPPPPPPPPPPPPPPP
FPFPPPPPPPPPPPPPPPPPPPPPPPPPPPPPPPPPPPPPPPPPPPPPPPPPFPPPPPPPPPPPPPPPPP
PPPPFFPPPPPPPPPPPPPPPPPPPPPPPPPPPPPPPPPPPPFFPFFPPPPPPPPPPPPPPPPPPPPPPP
PPPPPPFPPPPPPPPPPPPPPPPPPPPPPFPPPPFFPPPPPPPPPPPPPPPPPPPPFPPPPPPPPPPPPP
5A03JGN00-ATM4614P06QA2201
3
4299
251
70
65
FPPPPPPPPPPPPPPPPFPPPPPPPPPPPPPPPPPPPPPPPPPPPPPPPPPPPPPPPPPPPPPPPPPPPP
PPPPPFFFPPPPPPPPPPPPPPPPPPPPPPPPPPPPPPPPPPPPPPPPPPPPPPPPPPPPPPPPPPPPPP
PPPPPPPFPPFFFFPPPPPPPPPPPPPPPPPPFFPFPPPPPPPPPPPPPPPPPPPPPPPPPPPPPPPPPF
PPPPPPPPPPPPPPPPPPPPPFPPPPPPPPPPPPPPPPPPPPPPPPPPPPPPPPPPPPPPPPPPPPPPPP
PPPPPPPPPPPPPPPPPPPPPPPPPPPPPPPPPPPPPPPPPPPPPPPPPPPPPPPPPPPPPPPPPPPPPP
PFPPPPPPPFPPPPPPPPPFFPPPPPPPPPPPPPPPPPPPPPPPPPPPPPPPPPPPPPPPPPPPPPPPPP
PPPPFPPPPPPPPPPPPPPPPPPPPPPPPPPPPPPPPPPPPPPPPPPPPPPPPPPPPPPPPPPPPPPPFP
FPPPPPPPPPPPPPPPPPPPFFPPPPPPPPPPPPPPPPPPPPPPPPPPPPPPPPPPPPPPPPPPPPPPFF
PPPPPPPPPPPPPFFPPPPPPPPFFPPPPPPPPPPPPPPPPPPPPPPPPPPPFPPPPPPPPPPPPPPPPP
PPPPPPPPPPPPPPPPPPPPPPPPPFPPPPPPPPPPPPPPPPPPPPPPPPPPPPPPPPPFPPPPPPPPPP
PPPPPPPPPPPPPPPPPPPPPPPPFPPPPPPPPPPPPPPPPPPPPPPPPPPPPPPPPPPPPPPPPPPPPP
PPPPPPPPPPPPPPPPPPPPPPPPPPPPPPPPPPPPPPPPPPPPPPFFPPPFPFPFFPPPPPPPPPPPPP
PPPPPPPPPPPPPPPPPPPPPPPPPFPPPPPPPPPPPPPPPPPPPPPPPPPPPPPPPPPFPPPPPPPPPP
FPPPPPPPPPPPPPPPPPPPPPPPPPPPPPPPPPPPPPPPPPPPPPPPPPFFPPPPPPPPPPPPPPPPPP
PFPPPPPPPPPPPPPPPPPPPPPPPPPPPPPPPPPPPPPPPPPPPPPPPPPPPPPPPPFPPPPPPPPPPP
FPPPPPPPPPPPPPPPPFFPFFPPPPPFFPPPPPPPPPFPPPPPPPPPPPPPPPPPPPPPFFPPPPPPPP
PPPPPPPPPPPPPPFPPPPPPPPPPPPPPPPPPPPPPPPPPPPPPPPPPPFPPPPPPPPPPPPPPPPPPP
FPPPPPPPPPPFPPPPPPPPPPPPPPPPPPPPPPPPPPPPPPPPPPPPPPPPPPPPPPPPPPPPPPPPFP
PPPPPPPPPPPPPPPPPPPPPPPFPPPPPPPPPPPPPFPPPPPPPPPPPPPPPPPPPPPPPPPPPPPPPP
PPPPPPPPPPPPPPPPPPPPPPPPFPPPPPPPPPPPPPPPPPPPPPPPPPPPPPPPPPPPPPPPPPPPPP
PPPPFFPPPPPPPFPPPPPPPPPPPPPPPPPPPPPPPPPPPPPPPPPPPPPPPPPPPPPPPPPPPPPPPF
PPPPPPPPPPPPPPPPPPPPPPPPPFPPPFFPPFPPPPPFFPPPPFFPFPPPPPPPPPPPPPPFFPPPPP
PPPPPPPPPPPPPPPPPPPFFFPPPPPPPPPPPPPPPPFPPPPPPPPPPPFPPPPPPPPPPPPPPPPPFP
PFPPPPPPPPPPPPPPPPPPPPPPPPFPPPPPPPPPPFFPPPPPPPPPPPPPPPPPFFPPPPPPFFPPPP
PPFPPPPPPPPPPPPPPPPPPPPPFFPPPPPPFPPPPPPPPPPPPPPPPPPPPPPPPPPFPPPPPFPPPP
PPPPPPPPPPPPPPPPPPPPPPPPPPPPPPPPPPPPPPPPPPPFFPPPPPFPPPPPPPPPPPPPPPPPFP
PPPPPPPPPPFFPPPPPPPPPPFPPPPPPPPPPPPPPPPPPFPPPPPPPPPPPPPPPPPPPPPPPPPPPP
PPPPPPPPPPPPPPPPPPPFFPPPPPPPPPPPPPPPPPPPPPPPPPPPPPPPPPPPPPFPPPPPPPPPPP
PPFPPPPPPPPPPPPPPPPPPPPPPPPPPPPPPPPPPPPPFPPPPFPPPPPPPPPPPPPPPPPPPPPPPP
PPPPPPPPPPPPPPPPPPPPPPPPPPPPPPPPPPPPPPPPPPPPPPPPPPPFFPPPPPPPPPPPPPPPPP
PPPPPPPPPPPPPPPPPPPPPPPPPPPPPPPPPPPPPPPPFPPPPFPPPPPPPPPPPPPPPPPPPFPPPP
PPPPPPPPPPPPPPPPPPPPPPPPPPPPPPPPPPPPPPPPPPPPPPPPPPPPPPPPPPPPPPPPPPPPPP
PPPPPPPPPPPPPPPPPPPPPPPPPPPPFFPPPPPPPPPPPPPFFPPPPPPPPPPPPPPPPPPPPPPPPP
PPPPPPPPPPPPPPPPPPPPPPPPPPPPPPPPPPPPPPPPPPPPFFPPPPPPPPPPPPPPPPPPPPPPPP
PPPPPPPPPPPPPPPPPPPFPPPPPPPPPPPPPPPPPPPPPPPPPPPPPPPPPPPPPPPPPPPPPPPFFP
PPPPPPPPPPFFPPPPPPPPPPPPPPPPPPPPPPPPPPPPPPPPPPPPPPPPPPPPPPPPPPPPPPPPPF
PPPPPPPPPPPPPPPPPPPPPPPPPPPPPPPPPPPPPPPPPPPPPPFFPPPPPPPPPPPPPPPPPFFPPF
PPPPPPPPPPPPPPPPPPPPPPPPPPPPPPPPPPPPPPPPPPPPPPPPPPPPPPPPPPPPPPPPPPPPPP
PPPPPPPPPPPPPPPPPPPPPPPPPPPPPPFFPPPPPPPPPPPPPPPPPPPPPPPPPPPPPPPPPPPPPP
PPPPPPPPPPPPPPPPPPPPPPPPPPPPPPPPPPFFPPPPPPPPPPPPPPFFPPPPPPPPPPPPPPPPPP
PPPPPPPPPPPPPPPPPPPFFPPPPPPPPPPPPPPPPPPPPPPPPFPPPPPPPPPPPPPPPPFPPPPPPP
PPPPPPPPPPPPPPFFPPFPPPPPPPPPPPPFFPPPPPPPPPPPPPPPPPPPPPPPPFPPPPPPPPPPPP
PPPPPPPPPPPPPPPPPPPPPPPPPPPPPPPPPPPPPPPPPPPFPPFFPPPPPPPPPPPPPPPPPPPPPP
PPPPPPPPPPPPPPPPFPPPPFPPPPPPPPPPPPFPPPFPPPPPPPPPPPPPPPPPPPPPPPPPPPPPPP
PPPPPPPPPPPPPPPPPPPFFPPPPPPPPPPPPPPPPPPPPPPPPPPPPPPPPPPPPPPPPPPFFPPPPP
PPPPPPPPPPPPPPPPPFFPPPPPPPPPPPPPPPPPPPPPPPPPPPPPPPPPPPPPPPFPPPPPFPPPPP
PPPPPPPPPPPPPPPPPPPPPPPPPPPPPPPPPPPPPPPPPPPPPPPPPPPPPPPFPPPPPPPPPPPPPP
PPFFPPPPPPPPPPPPPPPPPPPPPPPPPPPPPPPPPPPPPPPPPPPPPPPPPPPPPPPFFPPPPPPPPF
PPPPPPPPPPPPPPPPPPPPPPPPPPPPPPPPPPPPPPPPPPPPPPPPPPPFPPPPPPPPPPPPPPPPPP
PPPPPPPPPPPPPPPPPPPPPPPPPPPPPPPPPPPPPPPPPFPPPPPPPPPFPPPFPPPPPPPPFPPPPP
PPPPPPFPFF***FF***FFPPPPPPPPPPPPPPPPPPPPPPPPPPPPPPPPPPPPPPPPPPPPPPPPPF
PPPPPPPPPPPPPPPPPPPPPPPPPPPPPPPPPPPPPPPPPPPPPPPPPPPPPPPPPPPPFPPPPPPPPP
PPPPPPPPPPPFFPPPPPPPPPPPPPPPPPPPPPPPPPPPPPPPPPPPPPPPPFFPFFPPPPPPPPPPPP
PPPPPPPPPPPPPPPPPPPPPPPFPPPPPPPPPPPPPPPPPPPPPPFFPPPPPPPPPPPPPPPPPPPPPP
PPPPPPPPPPPPPPPPPPPPPPPPPPPPFFPPPPPPPPPPPPPPPPPPPPPPPPPFPPPPPPPPPPPPPP
PPPFPPPPPPPPPPPPPPPPPPPPPPPPPPPPPPFPPPPPPPPPPFPPPPPPPPPPPPPPPPPPPPPPPP
PPPPPPPPPPPPPPPPPPPPPPPPPPPFPPPPPPPPPPPPPPPPPPPPPPFPFFFFFPPPFPPPPPPPPP
PPPPPPPPPPPPPPPFFPPPPPPPPPPPPPPPPPPPPFPPPPPPFFPPPPPPFPPPPPPPPPPPPFPPPP
PPFPPPPPPPPPPPPPPPPPPPPPPPPPPPPPPPPPPPPPPPPPPPPPPPPPPPPPPPPPPPPPPPPPPP
PPPPPPPPPPPPPPPPPPPPPPPPPPPPPPPPPFPPPPPPPPPPPPFPPPPPPPPPPPPPFPPPPPPPPP
PPPPPPPPPPPPPPPPPPFPPPPPPPPPPPPPPPPPPPPPPPPPPPPFFPPFPPPPPPPFPPPPPPPPPF
PPPPPPPPPPPPPPPPPPPPPPPPPPPPPFPPPPPPPPPPPPPPPPPPPPPPPPPPPPPFPPPPPPPPPP
PPPPPPPPPPPPPPFPPPPPPPPPPPPFFPPPPPPPPPPPPPPPPPPPPPPPPPPPPFPPPPPPPPFPPP
PPPPPPPPPPPPPPPPPPPPPPPPPPPFPPPPPPPPPPPPPPPPPPPFFPFPPPPPPPFPPPPPPPPPPP
PPPPPPPPPPPFFPPPPPPPPPPPPPFFPPPPPPPPPPPPPPPPPPFPPPPPPPPPPPPPPFPPPPPPPP
5A03JGN00-ATM4614P06QA2201
4
4250
300
70
65
PFPPPPFFPPPPPPPPPPPPPPPPPPPPPPPPPPPPPPPPPFPPPPPPPPPPPPPPPPPPPPPPPPPPPP
PPPPPPPPPPPPPPPPPPPPPPPPPPPPPPPPPPPPPPPPPPPPPPPPPPPPPPPPPFPPPFPPPPPPPP
PPPPPFPPPPPPPPPPPPPPPPPPPPPPPPPPPPPPPPPPPPPPPPPPPPPPPPPPPPPFPPPFPPPPPP
PPPPPPPPPPPPFPPPPPPPPPPPPPPPPPPPPPPPPFPPPPPPPPPPPPPPPPPPPFFPPPPPPPPPPP
PPPPPPPPPPPPPPPPPPPPPPPPPPPPPPPPPPPPPPPPPPPPPPPPPPPPPPPPPPPPPPPPPPPPPP
PPPPPPPPPPPPFFPPPPPPPPPPPPPPPPPPPPPPPPFFPPPPPPPPPPPPPPPPPPPPPPPPPPPPPP
PPPPPPPPPPPPPPPPPPPPPPPPPPPPPPFPPPPPPPPPPPPPPPPPPPFFPPPPFFPPPPPPPPPPPP
FPPPPPPPPPPPPPPPPPPPPPPPPPPPPPPPPPPPPPPFFPPPPPPPPPPFFPPPPPPPPPPPPPPPPP
PPPPPPPPPPPPFPPPPPPPPPPPPFFPPPPFPPFPPPPPPPPPPPPPPPPPPPPPPPPPPPPPPPPPPP
FFPPPPPPPPPPFPPPPPPPPPPPPPPPPPPPPPPPPPFPPPFFPPPPPPPPPPPPPPFPPPPPPPPPPP
PPPPPPPPPPPPPPPPPPPPPPPFPPPPPPPPPPPPPPPPPPPPPPPPPPPPPPPPFFPPPFFPPPPPPP
PPPPPPPPPPPPPPPPPPPPPPPPPPPPPPPFPPPPPPPFFPPPPPPPPPPPPPPPPPPPPPPPPPPPPP
PPPPPPPPPPPPPPPPPPPPPFFPPPPPPPPPPPPPPPPPPPPPPPPPPPPPPPFFPPPPPPPPFFFFPP
PPPPPPPPPPPPPPPPPPPPPPPPPPPPPPPPPPPPPPPPPPPPPPPPPPPPPPPPPPPFPPPPPPPPPP
PFPPPPPPPPPPPPPPFFFPFFPPPPPPPPPPPPPPPPPPPPFPPPPPPPPPPPPPPPPPPPPPPPPPPP
PPPPPPPPPPPPPPPPFPPPPPPPPPPPPPPPPPPFPPPPPPPPPPPPPPPPPPPPPPPPPPPPPPPFFF
PPPPPPPPPPPPPPPPFPPPPPPPPPPPPPPPPFPPPPPPPPPPPPPFPPPPPPPPPPPPPPPFFPPPPP
PPPPPPPPPPPPPPPFPPPPPPPPPPPPPPPPPPFFPPPPPPPPPPPPPFFPPPPPPPPPPPPPPPPPPP
PPPPPPPPPPPPPPPPPPPPPPPPPPPPPPPPPPPPPPPPPPPPPPPPPPPPPPPPPPFPFFPPPPPPPP
PPPPPPPPPPPPPPPPPPPPPPPPPPPPPPPPPPPPPPFFPPPPPPPPPPPPPPPPPPPPPPPPPPPPPP
PPPPPPFFPPPPPPPFFPFFPPPPPPPPPPPPPPPPPPPPPPPPPPPPPPPPPPPPPPPPPPPPPPPPPP
FPPPPPPPPPPPFPPPPPPFPPPPPPPPPPPPPPPPPPPPPPPPPPPPPPPFPPPFFPPPPPPPPPPPPP
PPPPPPPPPPPPPPFPPPPPPPPPPPPPPPPPPPPFFPPPPPPPPPPPPPPPFFPPPFFPPPPPPPPPPP
PPPPPPPPPPPPPPPPPPPPPPFPPPPPPPPPPPPPPPPPPPPPPPPPPPPPPPPPPPPPPPPPPPPPPF
PPPPPPPPPPPPPPPPPFFPPPPPPPPFPPPPPPPPPPPPPPPPPPPPPPPPPPPPPPPFPPPPPPPPPP
PPPPPPPPPPPPPPPFPPFFFFPFPPPPPPPPPPPPPFPPPPPPPPPPPPPPPPPPFFFFPPPPFPPPPP
PPPPPPPPPPPPPPPPFPPPPPPPPPPFPPPPFPPPPPFPPPPPPPPPPPPPPPPPPPPPPPPFPPPPPP
PPPPPPPPPFPPPPPPPPPPPPPPPPPPPPPPPPPPPPPPPPPPPPPPPPPPPPPFPPPPPPPPPPPFFP
PPPPPPPPPPPPPPPPPPPPPPFFPPPPPPPPPPPPPPPPPPPPPPPPPPPPPPPPPPPPPPPPPPPPPP
PPPPPPPPPPPFFFPFFPPPPPPPPPFFPPPPPPPPPPPPPPPPPPPFFPPPPPPPPPPPPPPPPPPPPP
PPPPPPPPPPPPPPPPPPPPPPPPPPPPPPPPPPPPPPPPPPPPPPPPFFPPPPPPPPPPPPPPPPPPPP
PPPPPPPPFPPPPPPPPPPPPPPPPPFFPPPPPPPPPPPPPPPPPPPPPPPPPPPPPPPPPPPPPPPPPP
PPPPPPPPPPPPPPPFFPPPPPPPPPPPPPPPPPPPPPFPPPPPPPPPPPPPPPPPPPPPPPFPPPPPPP
PPPPPPPPPPPPPPPPPPPPPPPPPPPPPPPPPPPPPFPPPPPPPPPPPPPFPPPPPPPPPPPPPPPPFP
PPPPPPPPPPPPPPPPPPPPPPPFFPPPPPPPPPPPPPPPPPPPPPPPPPPPPFFPPPPPPFFPPPPPPP
PPPPPPPPPPPPPPPPPPPPFPPPPPPPPPPPPPPPPPPPPPPPPPPPPPPPPPPPFPPFFPFFPPFPPP
PPPPPPPPPPPPPFPPPPPPPPPPPPPPPPPPPPPPPPPPPPPPPFFPPPPFFPPPPPPPPPPPPPPPPP
PPPPPPPPPPPPPPPPPPPPPPPPPFPPPFPPFPPPPPPPPPPPPPPPPPPPPPFPPPPPPPPPPPPPPP
PPPPPPPPPPPPPPPPPPPPPPPPPPPPPPPPPPPPFFPPPPFPPPPPPPFFPPPPPPPFPPPPPPPPPP
FFPPPPPFFPPPPPPPPPPPPPPPPPPPPPPPPPPPPFFFPPPPPPPPPPPFFPPPPPPPPPPPPPPPPF
PPPPPPPPPPPPPPPPPPPPPPPPPPPPPPPPPPPPFPPPPPPPPPPPPPPPPPPPPPPPFFPPPP*PPP
PPPPPPPPPPPPPPPPPPPPPPPPPFPPPFFPFFPPPPPPPPPPPPPPPPPPPPPPFFFPPPPPPP*PPP
PPPFPPPPPPPPPPPPPPPPPPPFPPPPPPPPPPPPPPPPPPPPPPPFPPPPPPFFFPPPPPFPPPPPPP
PPPPPPPPPPPPPPPPPPPPPFPFFPPPPPPPPPPPPPPPPPPPPPPPPPPPPPPPPPPPPPPPPPPPPP
PPPPPPPPPPPPPPPPPPPPPPFPFPPPPPPPPPPPPPPPPPPPFFPPPPPPPPPPPPPPPPPPPPPPFP
PPPPPPPPPPPPPPPPPPPPPPPPPPPPPPPPPFPPPPPPPPPPPPPPPPPPPPPPPPPPPPPPPPPPPP
PPPPPPPPPPPPPPPPPPPPPPPPPPPPPPPPPPPPPPPPPPFPPPPPPFFFFPPPPP*PPPPPPPPPFF
PPPPPPPPPPPPPPPPPPPPPPPPPFPPPPPPPPPPPPPPPPPPPPPFFPPPPPPPPPPPPPPPPPPPPF
PPPPPPPPPPPPPPPPPPPPPPPPPPPPPPPPPPPPPPPPPPPPPPPPPPPPPPPPPPPPPPPPPPPFPP
PPPPPPPPFPPPPPPPPPFPPPPPPPPPPPPFFFPPPPPPPPPPPPFPPPPPPPPPPPPPPPPPPPPPPP
PPFFPPPPPPPPPPPPPPPPPPPPPPPPPPPPPPPPPPPPPPPPPPPPPPPPPPPPPPPPPPFFPPPPPP
PPPPPPPPPPPPPPPPPPPPPPPPPPPPPPPPPPPPPPPPPPPPPPPPPPPPPPPPPPPPPPPPPPPPPP
PPPPPPPPPPPPPPPPPPPFPPPPPPPPPPPPPFPPPPPPPPPPPFPPPPPPPPPPPPPPPPPPPPPPPP
PPPPPPPPPPPPPPPPPPPPPPPPPPPPPPPPPPPPPPPPPPPPPPPPPPPPPPPPPPFPPPPPPPPPPP
PPPPPPPPPPPPPPPPPPPPPPPPPFFPPPPPFPPPPPPPPPPPPPPPPPPPPFPPPPPFFFFPPPPPPP
PPPPPPPPPPPPPPPPPPPPPPPPPPPPPPPPPPPPPPPPPPPPPPPPPPPPPPPPPPPPPPPPPPPFFP
PPPPPPPPPPPPPPPPPPPPPPPPPPPPPPFPPPPPPPPPPPPPPPPPPPPPPPPPFFPPPPPFFPPPFF
PPPPPPPPPPPFPPPPPPPPPPPPPPPPPPPPPPPPPPPPPPPPPPPPPPPPPPPPPPPPPPPPPPPPPP
PPPPPPPPPPPPPPPPFPPPPPPPPPPPPPPPPPPPPPPPPPPPPPPPPPPPPPPPPPFPPPPPPPFPFP
PPPPPPPPPPFPPPPPPPPPPPPPPPPPPPPPPPPPPPPPPPPPPPPPPPPPPPPPPPPPPPPPPPFFPP
PPPPPPPPPPPPPPPPPPPPPPPPPPPPPPPPPPPPPPPPPPPPPPPPPPPPPPPPPPPPPFPFPPPPPP
PPPPPPPPPPPPPPPPPPPPPPPPPPPPPPPPPPPPPPPPPPPPPPPPPPPPPPFFPPPPPFFPPPPPPF
PPPPPPPPPPPFFPPPFPPPPPPPPPPPPPPPPPPPFFPPPPPPPPPPPPPPPPPFFPPPPPPPPPPPPP
PPPPPPFPPPPPPPPPPPFPPPPPPPPPPPPPPPPPPPPPPPPPPPPPPPFPPPPPPPPPPPFFPPPPPP
PPPFPPPPPPPPPPPPFPPPPPPPPPPPPPPPPPPFFPPPPFFFPPPPPPFFPPPPPPPPPPPPPPPFPP
