5A03JGN00-ATM4613P31QA1221
1
4312
238
70
65
PPPPPPPPPPPPFFPPPPPPPPPPPPPPPPPPFFPPPPPPPPPPPPPPPPPPPPPFPPPPPPPPPPPFPP
FFFFPFPPPPPPFPPPFPPPPPPPPPFPPFFPPPPPPPPPPPPPPPPPPPPPPPPPPPPPPPPPPPPPPP
PPPPPPPPPPPPFFPPPPPPPPPPPFPPPPFPPPPPPPPPPFPPPPPPPPPPPPPPPPPPPPPPPPPPPP
PPPPPPPFPPPPPPPPPPPPPPPPPPFFPPPPPPPPPPPPPPPPPPPPPPPPPPPPPPPPPPPPPPPPPP
PPPFPPPPPPPPPPPPPPFFFPPPPPPPPPPPPPPPPPPPPPPPPPPPPPPFFPPPPPPPPPPPPPPPPP
PPPPPPPPPPPPPPPPPPPPPPPFPPPPPPPPFFPPPPPPPPPPPPPPPPPPPPPPPPPPPPPPPPPPPP
PPPPPPPPPPFFPPPPPPPPPPPPPPPPPPPPPPPPPPPPPPPPPPPPPPPPPPPPPPPPPPPPPPPPPP
PPPPPPFPPPPPFPPPPPPPPPPPPPPPFPPPPPPPPPPPPPPPPPPPPPPPPPPPPPPPPPPPPPPPPP
PPPPPPPPPPPPPPPPPPPPPPPPPPPPPPPPPPPPPPPPPPPPPPPPPPPPPPPPPPPPPPPPPPPPPP
PPPPPPPPPPPPPFPPPPPPPPFPPPPFPPPPPPPPFPPPPPPPPPPPPPPPPPPPPPPPPPPPPPPPPP
PPPPPPPPPPPFPPPPPPPPPPPPPPPPPPPPPPPPPPPPPPPPPPPPPPPPPPPPPPPPPPPPPPPPPP
PPPPPPPPPPPPPPPPPPPPPPPPPPPPPPPPPPPPPPPPPPPPPPPPPPPPPPPPPPPPPPPPPPPPPP
PPPPPPPFPPFPPPPPPPPPPPFPPPPPPPPPPPPPPPPPPPPPPPFFPPPPPPPPPPPPFPPPPPFPPP
PPPPPPPPPPPPPPPPPPPPPPPPPPPPPPPPPPPPPPPPPPPPPPPPPFPPPPPPPPPPPPPPPPPPPP
PPPPPPPPPPPPPPPPPPPPPPPPPPPPPPPPPPPPPPPPPFPPPPPPPFPFPPPPPPPPPPPPPPPPPP
PPPPPPPPPPPPPPPPPPPPPPPPPPPPPPPPPPPPPPPPPPPPPPPPPPPPPPPPPPPPPPPPPPPPPP
PPPPPPPPPPPPPPPPPPPPPPPPPPPPPPPPPPPPPPPPPPPPPPPPPPPPPPPPFFPPPPPPPPPPPP
PPPPPPPPPPPPPPPPPPPPPPPPFPPPPPPPPPPPPPPPPPPPPPPPPPPPPPPPPPPPPPPPPPPPPF
FPPPPPFPPPPPPPPPPPPPPPPPPPPPPPPPPPPPPPPPPPPPPPPPPPPPPPPPPPPPPPPPFPPPPP
PPPPPPPPPPPPPPPPPPPPPPPPPPPPPPPPPPPPFPPPPPPPPPPPPPPPPPPPPPPPPPPPPPPPPP
PPPPPPPPPPPPPPPPPPPPPPPPPPPPPPPPPPPPPPPPPPPPPPPPPPFFPPPPPPPPPPPPFPPPPP
PPPPPPPPPPPPFPPPFPPPPPPPPPPPPFFPPPPPPPPPPPPPPPPPPPPPPPPPPPPPPPPPPPPPPP
PPFFPPPPPPFPPPPPPPPPPPPPPPPPPPPPPPPPPPPPPPPPPPPPPPPPPPFFPPPPPPPPPPPPPF
PPPPPPPPPPPPPPPPPPPPPPPPPPPPPPPPPPPPPFFPPPPPPPPPPPPPPPPPFPPPPPPPPPPPFP
PPPPPPPPPPPPPPPPPPPPPPPPPPPPPPPPPPPPPPPPPFFPPPPPPPPPPFFPPPPPPPPPPPPPPP
FPPPPPPPPPPPPPPPPPPPPPPPFFPPPPPPPPFFPFPPPPPPPPPPPPPPPPPPPPPPPPPPPPPPPP
PPPPPPPFFPPPPPPPPPFPPPPPPPPPPPPPPPPPPPPPPPPPPPPPPPPPPPPPPPPPPPPPPPPPPP
FPPPPPPPPPPPPPPPPPPPPPPPPPPPPPFPPPPPPPPPPPPPPFPPPPPPPPPPPPPPPPFPPPPPPP
PPPPPPPFPPPPPPPPPPPPPPPPPPFFPPPPPPPPPPPPPPPPPPPPPPPPPPPPPPPPPPPPPPPPPP
PPPPPPPPPPPPPPPFFPPPPPPPPPPPPPPPPPPPPPPPFPPPPPPPPPPPPPPPPPPPPPPPPPPPPP
PPPPPPPPPPPPPPPPPPPPPPPPPPPPPFPPPPPPPPPPPPPPPPPPPPPPPPPPPPPPFPPPPPPPPP
PPPPPPPPPPPPPPFPPPPPPPFPPPPPPPPPPPFFPPPPPPPPPPPPPPPPPPPPPPPPPPPPFFPPFP
PPPPPPPPPPPPPPPPPPPPPPPPFFPPPPPPPPPPPPPPPPPPPPPPPPPPFPPPFFPPPPPPPPPPPP
PPPPPPPPPPPPPPFPPPPPPPPPPPPPFFPPPPPPPPPPPPPFFPPPPPPPPPPPPPPPPPPPPPPPPP
PPPPPPPPPPPPPPPPPFPPPPPPPPPPPPPPPPPPPPPPPPPPPPPPPPPPPPPPPPFPFPPPPPPPPP
PPPPPPPPPPPPPPPPPPPPFFPPPPPPPPPPPPPPPPPPPPPPPPPPPPPPPPPFPPPPPPPPPPFPPP
PPPPPPFPPPPPPPPPPPPFPPPPPPPPPPPPPPPPFFPPPFPPPPPPPPPPPPPPPPPPPPPPPPPPFP
PPPPPPPPPPPPPPPPFPPPPPPPPPPPPPPPPPPPPPPPPPPPPPPPPPPPPPPPPPPPPPPPPPPPPP
PFPPPPPPPPPPPPPPFPPFFPPPPPPPPPPPPPPPPPPPPPPPPPPPPPPPPPPPPPPPPPPPPPPPPP
PPPPPPPPPPPPPPPPPPPPPPPPPPPPFPPPPPPPPPPPPPPPPPPPPPPPPPPPPPPFFPPPPPPPPP
PPPPPPPPPPPPPPPPPPFPPPPPPPPPPPPFPPPPPPPPPPPPPPPPPPPPPPPPPPFFPPFPPPPPPP
PFPPPPPPPPPPPPPPPPPPPPPPPPPPPPPPPPFPPPPFPPPFFPPPPPPPPPPPPPPPPPPPPPPPPP
PPPPPPPPPPPPPFPPPPPPPPPPPPPPPPPPFPPPPPPPPPPPPPPPPPPPPPPPPPPPPPPPPPPFFP
PPPPPPPPPPPPPPPPPPPPPPPPPFPPPPPPPPPPPPPPPPPPPPPPPPPPPPPPPPPPPPPPPPFFPP
PFPPPPPPPPPPPPPPPPPPPPPPPPPPPPPPPPPPPPPPPPPPPPPPPPPPPPPPPPPPPPFPPPPPPP
PPPPPPPPPPPPFFPPPPPPPPPPPPPPPPPPPPPPPPPPPPPPPPPPPPPPPPPPPPPPPPPPPPPPPP
PPPPPPPPPPPPPPPPPPPPPPPPPPPFFFFPPPPPPPPPPPPFPPPPPPPPPPPPPPPPPPPPPPPPPP
FPPPPPPPPPPPFFPPPPPPPPPPPPPPPPPFPPPPFPPPPPPPPPPPPPPPFPPPPFPPPPPPPPPPFP
PPPPPPPPPPPPPPPPPPPPPPPPPPFPPFPPPPFPPPPPPPPPPPPPPPPPPPPPPPFPPPPPPPPPPP
PPPPPPPPPPPPPPPPPFPPPPPPPPPPPPPPFFFFPPPPFPPPPPPPPPPPPPPPPPPPPPPPPPFFPP
PPPPPPPPPPPPPPPPPPPPPPPPPPPPPPFFPFFFPFPPFPPPPPPPPPPPPPFPPPPPPPPPPPFFPP
PPPPPPPPPPPPFPPPPPPPPPPPPPPPFPPPFFFPPPPPPPPPPPPPPPPPPFPPPPPPPPPPPPFPPP
PPPPPPPPPPPPPPPPPPPPPPPPPPPPPPPPFFFFFPPPPPPPPPPPPPPPPPPPPPPPPPPPPPPPPP
PPPPPPPPFFPPPPPPPPPPPPPPPPPPPPPPPPPPPPPPPPPPPPPPPPPPPPPFFPPPPPFPPPPPPP
PPPPPPPPPPFPFFPPPPPPPFPPPPPPPPPPPPPPPPPPPPFPPPPPPPPPPPPPPFPPPPFPPPPPPP
PPPPPPPPPPFFPPPPPPPPPPPPPPPPPPPPPPPPPPPPPPPPPPPPPPPPPPPPPPPPPPPPPPPPPP
PPPPPPPPPPPPPPPPPPPPPPPPPPPPPPPPPPPPPPPPPPPPPPPPPPPPPFPFFPPPFPPPPPPPPP
PPPPPPPPPPPPPPPPPPFPPPPPPPPPPPPPPPPPPPPPPPPPPPPPPPPPPPPPPPFPPPPPPPPPPP
PPPPPPPPPPPPPPPPPPPPPPPPPPPPPPPPPPPPPFFPPPPPPPPPPPPPPPPPPPFPPPPPPPPPPP
PPPPPPPPPPPPPPPPPPPPPPPPPPPPPPPPPPPPPPPPPPPPPPPPPPPPPPPPPPPPPPPPPPPPPP
PPPPPPPPPPPPPPPPPPPPPPPPPPPPPPPPPPPPPPPPPPPPFPPPPPPPPPPPPPPPPPPPPPFPPP
PPPPPPPPPPPPPPPPPPPPPPPPPPPPPPPPPPPPPPPPPPPPPPPPPPPPPPPPPPPPPPPPPPPPPP
PPPPPPPPPPPPPPPPPPPPPPPPPPPPPPPPPPPPPPPPPPPPPPPPPPPPPPPPPPPPPPPPPPPPPP
PPPPPPFPPPPPPPPPPPPPPPPPPPPPPPPPPPPPPPPPPPPPPPPPPPFPPPPPPPPPPPPPPPPPPP
PPPPPPPPPPPPPPPPPPPPPPPPPPPPPPPPFPPPPPPPPPPPPPPPPPPPPPPPPPPPPPPPPPPPPP
5A03JGN00-ATM4613P31QA1221
2
4270
280
70
65
FFFFFFFFFFFFFFFFFFFFFFFFFFFFFFFFFFFFFFFFFFFFFFFFFFFFFFFFFFFFFFFFFFFFFF
PPPPPPPPPPPPPPPPPPPPPPPPPPPPPPPPPPPPPPPPPPPPPPPPPPPPPPFPPPPPPPPPPPPPPP
PFPPPPPPPPPPPPPPPPPPFFPPPPPPPPPPPPPPPPPPPPPPPPPPPPPPPPPPPPPPPPPPPPPPPP
PPPPPPPPPPPPPPPPPPPPPPPPPPPPPPPPPPPPPPPPPPPPPPPPPPPPPPPPPPPPPPPPPPPFPP
PPPPPPPPPPPPPPPPPPPPPPPFPPPPPPPPPPPPPPPPPPPPPPPPPPPPPPPPPPPPPPPFPPPPPP
PPPPPPPPPPPPPPPPPPPPPPPPPPPPPPPPPPPPPPPPFPFPPPPPPPPPPPPPPPPPPPPPPPPPPP
PPPPPPPPPPPPPPPPPPPPPPPPPPPPPPPPPPPPPPPPPPPPPPPPPFFPPPPPPPPFPPPPPPPPPP
PPPPPPPPPPPPPPPPPPPPPPPPPPPPPPPPPPPPPPPPPPPPPPPPPPPPPPPPPPPPPPPPPFPPPP
PPPPPPPPPFPPPPPPPPPPPPPPPPPPPPPPPPPPPPPPPPPPPPPPPPPPPPPPPPPPPFPPPPPPPP
PPPPPPPPPPPPPPPPPPPPPPPPPPPPPPFPPPPPPPPFPPPPPPPPPPPPPPPPPPPPPPPPPPPPPP
PPPPPPPPPPPPPPPPPPPPPPPPPPPPPPPPFFPPPPPPPPPPPPPPPPPPPPPPPPPPPPPPPPPPPP
PPPFPPPPPPPPPPPPPPPPPPPPPPPPPPPPPPPPPPPPPPPPPPPPPPPPPPPPPPPPPPPPPPPPPP
FFPPPPPFPPPPPPPPPPPPPPPPPPPPPPPPPPPPPPPPPPPPPPPPPPPPPPPPPPPPPPPPPPPPPP
PPPPPPPPPPPPPPPFPPPPPPPPPPPPPFPPPPPPPPPPPPPFPPPPPPPPPPPPFFPPPPPPPPPPPP
PPPPPPPPPPPPPPPPPFPPPPPPPPPPPPPPPPPPPPPPPPPPPPPPPPPFPPPPPPPPPPPPPPPPPP
PPPPPPPPPPPPPPPPPPPPPPPPPPPPPPPPPPPPPPPPPPPPPPPPPPPPPPPPPPPPPPPPPPPPFP
PPPPPPPPPPPPPPPPPPPPFPPPPPPPPPPPPPPPPPPPPPPPPPPPPPPPPPPPPPPPPPPPPPPPPP
PPPPPPPPPPPPPPPPPPPPPPPPPPPPPPPPPPPPPPPPPPPPPPPPPPPPPPPPFPPPPPPPPFPPPP
PPPPPPPPPPPPPPPPPPPPPPPPPPPPPPPPPPPPPPPPPPFPPPPFPPPPPPPPPPPPFFPPPPPFFP
PPPPPPPPPPPPPPFPPPPFPPPPPPPPPPPPFFFFFFPPPPPPPPPPPPPPPPPPPPPPPPPPPPPPPP
FPPPPPPFPPPPFPPFPPPPPFFPPFPPPPPPPPPPPPPPPPPPPPPPPPPPPPPPPPPPPPPPPPPPPP
FPPPPPPPPPPPPPPPPPPPPPPPPPPPPPPPPFPPPPPPPPPPPPPPPPPPPPPFFFFFFFPPPPPPPP
PPPPPPFPPPPPPPPPPPPPPPPPPPPPPPPFPPPPPPPPPPPPPPPPPPPPPFFFPPFFFPFPPPPPPP
FFFPPPPPPPPPPPFFFFPPPPPPPPPPPPPPPPPPPPPPPPPPPFFPPPFFFPPFPPPPPPPPPPPPPP
PPPPPPPPFPPPPFFFPPPPPFFPPPPPPPPPPFFFFFPPPPPPPPPPPPPPPPPPPPPPPPPPPPPPPP
PPPPPPPPPPPPPPPPPPPPPPPPPPPPPPPPPPPPPPPPPPPPPPPPPPPPPPPPPPPPPPPPPPPPPP
PPPPPPPPPPPPPPPPPFPPPPPPPPPPPPPPPPPPPPPPPPPPPPPPPPPPPPPPPPPPPPPPPPPPPP
PPPPPPPPPPPPPPPPPPPPPPPPPPPPPPPPPPPFPPPPFPPPPPPFPPPPPPPPPPPPPPPPPPPPPP
PPPPPPPPPPPPPPPPPPPPPPPPPPPPPPPPPFPPPPPPPPPPPPPPPPPPPPPPPFPPPPPPPPPPPP
PPPPPPPPPPPPFPPPPPPPPPPPPPPPPPPPPPPPPPFFPPPPPPPPPPPPPPPPPPPPPPPPPPPPPP
PFPPPPPPPPPPPPPPPPPPPPPPPPPPPPPPPPPPPPPPPPPPPPFPPPPPPPPPPPPPPPPPPPPPPP
FFPPFPPPPPPPPPPPPPPPPPPPPPPPPPPPPPPPPPFFPPPPPPPPPPPPPPPPPPPPPPPPPPPPPP
PFPPPPPPPPPPPPPPPPPPPPPPPPPPPPPPPPPPPPPPPPPPPPPPPPPPPPPPPPPPPPPPPPPPPP
FPFFPPPPPPPPFPPPPPPPPFFPPPPPPPPPPPPPPPPPPPPPPPPPPPPPPPPPFPPPPFPPPFPPPP
PPPPPPPPPPPPPPPPPPPPPPPPPPPPPPPPPPPPPPPPPPPPPPPPPPPPPPPPPPPPPPPPPPPPPP
PPPPPPPPPPPPPPPPPPPPPFPPPPPPPPPPPPPPPPPPPPPPPPPPPPPPPPPPPPPPPPPPFPPPPP
PPPPPPPPPPPPPPPPPPPPPPPPPPPPPPPPPPPPPPPPPPPPPPPPPPPPPPPPPPPPPPPPPPPPPP
PPPPPPPPPPPPPPPPPFPPPPPPPPPPPPPPPPPPPPPPPPPPPPPPPPPPPPFPPPPPPPPPPPPPPP
PPPPPPPPPPPPPPPPPPPPPPPPPPPPPPPPPPPPPPPPPPPPPPPPPPPPPPPPPPFPPPPPPPPPPP
PPPPPPPPPPPPFFPPPPPPPPPPPPPPPPPFPPPPPPPPPPPPPPPPPPPPPPPPPPPPPPPPPPPPPP
PPPPPPPPPPPPPPPPPPPPPPPPPPPPPPPPPPPPPPFPPPPPPPPPPPPPPPPPPPPPPPPPPPPPPP
PPPPPPPPPPPPPPPPPPPPPPPPPPPFPPPPPPPPPPPPPPPPPPPPPPPPPPFPPPPPPPPPPPPPPP
PPPPPPPPPPPPPPPPPPPFPPPPPPPPPPPPPPPPPFPPPPPPPPFPPPPPPPPPPPPPPPPPPPPPPP
PPPPPPPPPPPPPPPPPPPPPPPPPPPPPPPPPPPPPPPPPPFPPPPPPPPPPFPPPPPPPPPFPPPPPP
FPPPPPPPPPPPPPPPPPPPPPPPPPPPPPPPPPPPPPPPPPPPPPPPPPPFPPPPPPPPPPPPPPPPPP
PPPPPPPPPPPPPPPPPPPPPPPPPPPPPPPPPPPPPPPPPPPPPPPPPFPPPPPPPPPPPPPPFPPPPP
PPPPPPPPPPPPPPPPPFPPPPPPPPPPPPPPPPPPPPPPPPPPPPPPPPPPPPPPPPPPPPPPPPPPPP
FPPPPPPPPPPPPPPPPPPPPPPPPPPPPPPPPPPPPPPPPPPPPPPPPPPPPPPPPPPPPPPFFPPPPP
PPPPPFFPPPPPPPPPPPPPPPPPPPPPFPPPPPPPPPPPPPPPPPPPPPPPPPPPPPPPPPPPPPPPFP
PPPPPPPPPPPPPPPPPPPPPPPPPPPPPPPPPPPPPPPPPPPPPPPPPPPPPPPPPPPPPPFPPPPPPP
PPPPPPPPPPPPPPPPPPPPPPPPPPPPPPPPPPPPPPPPPPPPPPPPPPPPF*FPFF*FFPPPPPPPPP
PPPPPPPPPPPPPPPPPPPPPPPPPPPPPPPPPPPPPPPPPPPPPPPPPPPPPPPPPPPPPFFF***FFF
PPPPPFFFFFFFPPPPPPPPPPPPPPPPPPPPPPPPPPPPPPPPPPPPPPPPPPPPPPPPPPPPPPPPPP
PPPPPPPPPPPFPPPPPPPPPPPPPPPPPPPPPPPPPPPPPPPPPPPPPPPPPPPPPPPPPPPPPPPPPP
PPPPPPPPPPPPPPPPFPPPPPPPPPPPPPPPPPPPPPPPPPPPPPPPPPPPPPPPPPPPPPPPPPPPPP
PPPPPPPPPPPPPPPPPPPPPPPPPPPPPPPPPPPPPPPPPPPPPPPPPPPPPPPPPPPPFPPPPPPPPP
PPPPPPPPPPPPPPPPPPPPPPPPPPPPPPPPPPPPPPPPPPPPPPPPPPPFPPFPPPPPPPPPPPPPPP
PPPPPPPPPPPPPPPPPPPPPPPFPPPPPPPPPPPPPPPPPPPPPPPPPPPPPPPPPPPPPPPPPPPPPP
PPPPPPPPPPPPPPPPPPPPPPPPPPPPPPPPFPPPPPPPPPPPPPPPPPPPPPPPPPPPPPPPPPPPPP
PPPPPPPPPPPPPPPPPPPPPPPPPPPPPPPPPFFPPPPPPPPPPPFPPPPPPPPPPPPPPPPPPPPPPP
PPPPPPPPPPPPPPPPPPPPPPPPPPPPPPPPPPPPPPPPPPPPPPPPPPFPPPPPPPPPPPPPPPPPPF
PPPPPPPPPPPPPPPPPPPPPPPPPPPPPPPPPPFPPPPPPPPPPPPPPPPPPPPPPPPPPPPFPPPPPP
PPPPPPFPFPPPPPPPPPPPPPPPPPPPPPPPPPPPPPFFPPPPPPFPPPPPPPPPPPPPPPPPPPPPPP
PPPPPPPFPPPPPFPPPPPPPPFFPPFFPPFFPPPPPPPPPPPPFPPPPPPPPPPPPFPPPPPPPPPPPP
PPPPPPPPPPPPPPPPPPPPPPPPPPPPPPPPFPPPPPPPPPPFPPPPPPPPPPPPPPPFPPPPPPPFPP
5A03JGN00-ATM4613P31QA1221
3
4354
196
70
65
PPPPPPPPPPPPPPPPPPPPPPPPPPPPPPPPPPPPPPPPPPPPPPPPPPPPPPPPPPPPPPPPPFPPPP
PPPPPPPPPPPPPPPPPPPPPPPPPPPPPPPPPPPPPPPPPPPPPPFPPPPPPPPPPPPPPPPPPPFPPP
PPPPPPPPPPPPPPPFFPPPPPPPPPPFPPPPPPPPPPPPPPPPPPPPPPPPPPFPPPPPPPPPPPPPPP
PPPPPPPPPPPPPPPPPPPPPPPPPPPPPPPPPPPPPPPPPPPPPPPPPPPPPPPPPPPPPPPPPPPPPP
PPPPPPPPPPPPPPPPPPPPPPPPPPPPPPPPPPPPPPPPPFPPPPPPPPPPPPPPPPPPPPPPPPPPPP
PPPPPPPPPPPPPPPPPPPPPPPPPPPPPPPPFPPPPPPPPPPPPPPPPPPPPPPPPPPFPPPPPPPPPP
PPPPPPPPPPPPPPPPPPPPPPPPPPPPPPPPPPPPPPPPPPPPPFPPFPPPPPFPPPPPPPPPPPPPPP
PPPPPPPPPPPPPPPPPPPPPPPPPPPPPPPPPPPPFPPPPPPPPPPPPPPPPPPPPPPPPPPPPPPPPP
PPPPPPPPPPPPPPPPPPPPPPPPPPPPPPPPPPPPPPPPPPPPPPPPPPPPPPPPPPPPPPPPPPPPPP
PPPPPPPPPPPPPPFPPPPPPPPPPPPFPPPPPPPPPPPPPPPPPPPPPPPPPPPPPPPPPPPPPPPPFP
PPPPPPPPPPPPPPPPPPPPPPPPPPPPPPPPPPPPPPPPPPPPPPPPPPPPPPPPPPPPPPPPPPPPPP
PPPPPPPPPPPPPPPPPPPPPPPPPPPPPPPPPPPPPPPPPPPPPPPPPPPPPPPPPPPPPPFFPPPPPP
PPPPPPPPPPFFFPFPPPPPPPPPPPPPPPPPPPPPPPPPPPPPPPPPPPPPPPPPPPPPPPPPPPPPPP
PPFPPPPPPPPPPPPPPPPPPPPPPPPPPPPPPPPPPPPPPPPPPPPPPFFPPFPPPPPFPPPPPPPPPP
PPPPPPPPPPPPPPPPPPFPPPPPPPPPPPPPPPPPPPPPPPPPPPPPPPPPF*FPPF*FPPPPPPPPPP
PPPPPPPPPPPPPFFPPPPPPPPPPPPPPPPPPPPPPPPPPPPPPPPPPPPPPPPPPPPPPFPPPPPPPP
PPFPPPPPPPPPPPPPPPPPPPPPPPPPPPPPPPPPPPPPPPPPPPPPPPPPPPPPPPPPPPPPPPPPPP
PPPPPPPPPFFPPPPPPPPPPPPPPPPPPPPPPPPPPPPPPPPPPPPPPPPPPPPPPPPPPPPPPPPPPP
PPPPPPPPPPPPPPPPPPPPPPPPPPPPPPPPPPPPPPPPPPPPPPPPPPPPPPPPPPPPPPPPPPPFPP
FFPPPPPPPPPPPPPPPPPPPPPPPPPPPPFPPPPPPPPPPPPPPPPPPPPPPPPPPPPPPPPPPPPPPF
FFPPPPPFPPFPPPFFPPPPPPPPPPPPPPPPPPPPPPPPPPPPPPPPPPPPPPPPPPPPPPPPPPFPPP
PPPPPPPPPPPPPPPPPPPPPPPPPPPPPFPPPPPPPPPPPPPPFPPPPPPPPPPPPPPPPPPPPPPPPP
PPPPPPPPPPPPPPPPPPPPPPPPPPPPPPFPPPPPPPPPPPFPPPPPPPPPPPPPPPPFPFPPFPPPPP
PPPPPPPPPPPPPPPPPPPFPPPPFPPPPPPPPPPPPPPPPPPPPPPPPPPPPPPPFFPPPPPPPPPPPP
PPPPPPPPPPPPPPPPPPPPPPPPPPPPPPPPPPPPPPPPPPPPPPPPPPPPFFPPPPPPPPPPPPPPPP
PPFPPPPPPPPPPPPPPPPPFPPPPPFFPPPPPPPPPPPPPPPPPPPPPPPPPPPPPPPPPPPPPPPPPP
PPPPPPPPPPPPPPPPPPPPPPPPPPPPPPPPPPPPPPPPPPPFFPPPPFPPPPPPPPPPPPPPPPPPPP
PPPPPPPPPPPFPPPPPPPPPPPPPPPPPPPPPPPPPPPPPPPPPPPPPPPFFPPPPPPPFPPPPPPPPP
PPPPPPPPPPPPPFPPFPPPPPPPPPPPPPPPPPPPPPPPPPPPPPPPPPPPPPPPPPPPPPPPPPPPPP
PPPPPPPPPPPPPPPPPPPPPPPPPPPPPPPPPPPPPPPPPPPPPPPPPPPPPPPPPPPPPPPPPPPPPP
PPPPPPPPPPPPPPPPPPPPPPPPPPPPPPPPPPPPPPPPPPPPPPPPPPFFPPPPPPPPPPPPPPPPFP
PPPPPPPPPPPPPPPPPPPPPPPPPPPPPPPPFPPPPPPPPPPPPPPPPPPPPPPPPPPPPPPPPPPPPP
PPPPFPPPPPPPPPPPPPPPPPPPPPPPPPPPFPPPPPPPPPPPPPPPPPPPPPPPPPPPPPPPPPPPPP
PPPPPPPPPPPPPPPPPPFPPPPPPPPPPFPPFFPPPPPPPPPPPPPPPPPPPPPPPPFPPPPPFPPPPP
PPPPPPPPPPPPPPPPPPPPPPPPPPPFPPPPPPPPPPPPPPPPPPPPPPPPPPPFFPPPPPPPPPPPPP
PPPPPPPPPPPPPPPPPPPPPPPPPPPPPPPPPPPPPPPPPPPPPPPPPPPPPPPPPPPPPPPPPPPPPP
FPPPPPPPPPPPPPPPPPPPPPPPPPPPPPPPPPPPPPPPPPPPPPFPPPPPPPPPPPPPPFPPPPPPPP
PPPPPPPPPPPPPPPPPPPPPPPPPPPPPPPPPFPPPPPPPPPFFPPPPPPPPPPPPPPPFPPPPPPPPP
PPPPPPPPPPPPPPPPPPPPPPPPPPPPPFPPPPPPPPFPPPPPPPPPPPPPPPPPPPPPPPPPPPPPPP
PPPPPPPPPPPPPPPPPPPPPPPPPPPPPPPPPPPPPPPPPPPPPPPPPPPPPPPPPPPPPPPPPPPPPP
PPPPPPPPPPPPPPPPPPPPPPPPPPPPPPPPPPPPPPPPPPPPPPPPPPPPPPPPPPPPPPPPPPPPPP
PPFPPPPPPPPPPPPPPPPPPPPPPPPPPPPPPPPPPPPPPPPPPPPPPPPPPPPPPPPPPFPPPPPPPP
PPPPPPPPPPPPPPPPFFPPPPPPPPFFPPPPPPPPPPPPPPPPPPFFPPPPPPPPPPPPPPPPPPPPPF
PPPPPPPPPPPPPPPPFPPPFPPPPPPPPPPPPPPPPPFPFPPPPPPPPPPPPPPPPPPPPPPPPPPPPF
PPPPPPPPPPPPPPPPPPPPPPPPFPPPFPFPPPPPPPPPPPPPPPPPPPPPPPPPPPPPPPPPPPPPPP
PPPPPPPPPPPPPPPPPPPPPPPFPFPPPPPPPPPPPPPPPPPPPPPPPPPPPPPPPPPPPPPPPPPPPP
PPPPPPPPPPPPPPPPPPPFFPPPPPPPPFPPPPPPPPPPPPFPPPPPPPPPPPPPPPPPPPPPPPPPPP
PPPPPPPPPPPPPPPPPPPPPPPPPPPPPPPPFPPPPPPPPPPFPPPPPPPPPPPPPPPFFPPPPPPPPP
PPPPPPPPPPFPPPPPPPPPPPPPPPPPPPFPPPPPPPPPPPPFFPPFPPPPPPPPPPPPPFFPPPPPPP
PPPPPPPPPPPPPPPPPFPPPPPPPPPPPPPPPPPPPPPPPPPPPPPPPPPPPPPFPPPPPPPPPPPPPP
PPPPPPFPPPPPPPPPPPPPPPPPPPPPPPPPPPPPFPPPPPPPPPPPPPPPPPPPPPPPPPPPPPPFPP
PPPPPPPPPPPPPPPPPPPPPPPPPPPPPFPPPFFPPPPPPPPPFPPPPPPPPPPPPPPPPPPPPPPPPP
PPPPPPPPPPPPPPPPPPPFPPPPPPPPPPPPPPPPPPPPPPPPPPPPPPPPPPPPPPPPPPPPPPPPPP
PPPPPPPPPPPPPPPPPPPPPPPPPPFPPPPPPPPPPPPPPPPPPPPFFPPFPPPPPPPPPPPFPPPPPP
PPPPPPPPPPPPPPPPPPPPPPPPPPPPPPPPPPPPPPPPPPPPPPPPPPPPPPPPPPPPPPPPPPPPPP
PPFPPPPPPPPPPPFFFPPPPPPPPPPPPPFPPPPPFPPPPPPPPPPPFFPPPPPPPPPPPPPPPPPPPP
PPPPPPPPPPPPPPPPPPPPPPPPPPPFPPPPPPPPPPPFPPPPPPPPPPPPPPPPPPPPPPFPPPPPPP
PPPPPPPPPPPPPPPPPPPPPPPPPPPPPPPPPPFPPPPPPPPPPPPPPPPPPPPPFFPPPPPPPPPPPP
PPPPPPPPPPPPPPPPPPPPPPPPPPPPPPPFPFPPPFPPPPPPPPPPPPPPPPPPPFFPPPPPPPPPPP
PPPPPPPPPPPPPPPPPPPPPPPPPPPPPPPPPPPPPPPFPFFPPPFFPPPFPPPPPPPPPPPPPPPPPP
PPPPPPPPPPPPPPPPPPPPPPPPPPPPPPPPPPPPPPPPPPPPPPPPPPPPPPPPPPPPPPPPPPFFPP
PPPPPPPPPPPFPPPPPPPPPPPPPPPPPPPFPPPPPPPPPPPPPPPPPPPFFPPPPPPPPPPPPPPFPP
PPPPPPPPPPPPPPPPPPPPPPPPPFPPPPPPPPPPPPPPPPPPPPPPPPPPPPPPPPPPPPPPPPPPPF
PPPPPPPPPPPPPPPPPFPPPPPPPPPPPPPPPPPPPPPPPPPPPPPPPPPPPPPFFPPPPPPFPPPPPP
PPPPPPPPPPPPPPPPPPFPPPPPPPPPPPFPPPPPPFPPPPFPPPPPPPPPPPPPPPFFPPPPPPPPPP
5A03JGN00-ATM4613P31QA1221
4
4320
230
70
65
PPPPPPPPPPPPPPPPPPPPPPPPPPPPPFPPPPPPPPPPPPPPPPPPPPPPF*FPPF*FPPPPPPFPPP
PPPPPPPPPPPFPPPPPPPPPPPPPPPPPPPPPPPPPPPPFPPPPPPPPPPFFPPPPPPFFPPPPPPPPP
PPFPPPPPPPPPPPPPPPPPPPPFFPPPPPPPPPPPPPPPPPPPPPPFPPPPPPPPPPPPPPPPPPPFFP
PPPPPPPPPPPPPPPPFPPPPPPPPPPPPPPPPPPPPPPPPPPPPPPPPPPPPPPPPPPPPPFPPPPPPP
PPPPPPPPPPPPPPPPPPPPFPPPPPPPPFFPPPPPPPPPPPPPPPPPPPPPPPPPPPPPPPPPPPPPPP
PPPPPPPPPPPPPPPPPPPPPPPPFFFFPPPPPPPPPPPPPPPPPPPPPPPPPPPPPPPPFFPPPPPPPP
PPPPPPPPPPPPPPPPPPPPPPPPPPPPPPPPPPPPPPPPPPFPPPFPPPPPPPPPPPPFPPPPPPPPPP
PPPPPPPPPPPPPPPPFPPPPPPPPPPPPPPPPFFPPPFPFFFFFFPFPPPPFPPPPPPPPPPPPFFFPP
FFPFPPFFPPPPPPPPPPPPFPFPPPPFPPPPPPPPPPPPPPPPPPPPPPPPPPPPPPPPPPPPPPFPPP
PPPPPPPPPPPPPPPPPPPPPPPPPPPPPPPPPPPPPPPPPPPPPPPPPPPPPPPPPPPPPPPPPPPPPP
PPPPPPPPPPPPPPPPPPPPPPPPPPPPPPPPPPPPPPPPPPPPPPPPPPPPPPPPPPPPPPPPPPPPFP
PPPPPPPPPFPPPPPPPPPPPPPPPPPPPPPPPPPPPPPPPPPPPPPPPPPPPPFFPPPPPPPPPFPPPP
PPFPPPPPPPPPPPPPPPPPPPFFPPPPPPPPPPPPPPPPFPPPPPPFFPPPPPPPPPPPPPPPPPPPPP
PPPPPPPPPPPPPPPPPPPFPPFFPPPPPPPPPPPPPPPPPPPPPPPPPPPPPPPPPPPPPPPPPPPPPP
PPPPPPPPPPPPPPPPPPPPPPPPPPPPPPPPPPPPPFPPPPPPPPPPPPPPPPPPFPPPPPPPPPPPPP
PPPPPPFPPFPPPPPPPPPPPPPPPPPPPPPPPPPPPPPPPPPPPPPPPPPPPPPPPPPPPPPPPPPPPP
PPPPPPPPPPPPPFFPPPPPPPPPPPPPPPPPPPPPPPPPPPPPPPPPPPPPPPPPPPPPPPPPPPPPPP
PPPPPFPPPPPFPPPPPPPPPPPPPPFPPPPPPPPPPPPPPFPPPPPPPPPPPPPPPPPPPPPPPFPPPP
PPPPPPPPPPPPPPPPPPPPPPPPPPPPPPPPPPPPPPPFPPPPPPPPPPPPPPPFPFPPPFFPPPPPPP
PPPPPPPPPPPPPPPPPPPPPPPPPPPPFPPPPPPFFPPPPPPPPPPPPPPPPPPPPPPFFPPPPPPPPP
PPPPPPPPPPPPPPPPPPFFPPPFPPPPPPPPPPPPPPPPPPPPPPPPPPPPPPPPPPPPPPPPPPPPPP
PPPPPPPPPPPPPPPPPPPPPPPPPPPPPPPPPPPPFPPPPPPPPPPPPPPPPPPPPPPPPPPPPPPPPP
PPPPPPPPPPPPPFPPPPPPPPPPPPPPPPPPPPPPPPPPPPPPPPPPPPFFPPPPPPPPPPPPPPPFPP
PFPPPPPPPPPPPPPPPPPPPPPPPPFPPPPPPPPPFPPPPPPPPFPPPPPPPPPPPPPPPPPPPPPPPP
PPPPPPPPPPPPPPPPPPPPPPPPPPPPPPPPPPPPPPPPPPPPPPPPPPPPPPPPPPPPPPPPPPPPPP
PPPPPPPPPPPPPPPPPPPPPPPPPPPPPPPPPPPPPPPPPPPPPPPPPPPPPPPPPPPPPPPPPPPPPP
PPPPPPPPPPPPPPPPPPPPPPPPPPPPPPPPPPPPPPPPPPPPPPPPPPPPPPPPPPPPPPPPPPPPPF
PPPPPPPPPPPPPPPFPFPPPPPPPPPPPPPPPPPPPPPPPPPPPPPPPPPPPPPPPPPPPPPFPPPPPP
PFPPPPPPPPPPPPPPPPPPPPPPPPPPPPPPPPPPPPPPPPPPPPPPPPPPPPPPPPPPPPPPPPPPPP
PPPPPPPPPPPPPPPPPPPPFPPPPPPPPPPPPPPPPPPPPPPFPPPPFPPPPFFPPPPPPPPPPPPPPP
PPPPPPPPPPPPPFFPPPPPPPFFPPPPPPPPPPPPPPPPPPPPPPPPPPPPPPPPPPPPPPPPPPPPPP
PPPPPPPPPPPPPPPPPPPPPPPPPPPPPPPPFPPPPPPPPPPPPPPPPPPPPPPPPPPPPPPPPPPPPP
PPPPPPPPPPPPPPPPPPPPPPPPPPPPPPPPPPPPPPPPPPPPPPPPPPPPPPPPPPPPPPPPPPFPPP
PPPPPPPPPPPPPPPPPPFFPPPPPPPPPPPPPPPPPPPPFFPPPPPPPPPPPPPPPPPPPPPPPPPFPP
PFPPPFPPPPPPPPPPPPPPPPPPPPPPPPPPPPPPPPPPPPPPPPPPPPPPPPPPPPPPPPPPPPPPPP
PPPPPPFPPPPPPPPPPPPPPPPPPPPPPPPPPPPPPPPPPPPPPPPPPPPPPPPPPPFPPPPPPPPFFP
PPPFPPPPPPPPPPPPPPPPPPPPPPPPPPPPPPPPPPPPPPPPPPPFPPPPPPPPPPPPPFPPPPFPPP
PPPPPPPPPPPPPPPPPPPPPPPPPPPPPPPPPPPPPPPPPFPPPPPPPPPPPFFPPPPPPPPPPPPPPP
PPPPPPPPPPPPPFPPPPPPPPPPPPPPPPPFPFPPPPPPPPPPPPPPPFPPPPPPPPPPPPPPPPPPPP
PPPPPPPPPPPPPPPPPPPPPPPPPPPPPPPPPPPPPPFFPPPPPPPFPPPPPPFFPPPPPPPPPPPPPP
PPPPPPPPPPPPPPPPFPPPPFFPPPPPPPPPPPPPPPPPPPPPPPPPPPPPPPPPPPPPPPPPPPPPPP
PPPPPPPPPPPPPPPPPPPPPPPPPPPPPPPFPPPPPPPPPPPPPPPPPPPPPPPPPPPFFPPPPPPPPP
PPPPPPPPFPPPPPFFPPPPPPPPPPPPPPPPPPPPPPPPPPPPPPPPPPPPPPPPPPFPPPPPPPPPPP
PPPPPPPPPPPPPPPPPPPFPPPPFPPFFFFFFPFFFFFFFFFFPPPPPPPPPPPPFPPPPFFPPPPPPP
PPPPPPPPPPPPPPPPPPPPPPPPPFFPPPPPPPPPPPFFPPPPPPPPPPPPPPPPPPPPPPPPPPPPPP
PPPPPPPPPPPPPPPPPFPPPPPPPPPPPPPPPPPPPPPPPPPPPPFPFPPPPPPPPPPPPPPPPPPFPP
PPPPPPPPPPPPPPPPPPPPPPPPPPPPPPPPPPPPPPFFFPFPPPPFFPPPPPFPPPPPPPPPPPPPFF
PPPPPPPPPPPPPPPPPPPPPPPPPFPPPPFFPPPPPPPPFPPPPPPPPPPPPPPPPPPPPPPPPPPPPP
PPPPPPPPPPPPPPPPPPPPPPFPPPPPPPPPPPPPPPFPPPFFFPFPPPPPPPFPPPPPPPPPPPPPPP
PPPPPPPPPPPPPPPPPPPPPPPPPPPPPPPPFPPPPPPPPPPPPPPPPPPPPPPFPPPPPPPPPPPPPP
PPPPPPPPPPPPFFPPFPPPPPPPPPPPPPPPPPPPPPPPPPPPPPPPPPPPPPPPPPPPPPPPPPPPPP
PPPPPPPPPPPPPPPPPPPPPPPPPPPPPPPPPPPPPPPPPPPPPPPPPPPPPPPPPPPPPPPPPPPPPP
PPPPPPPPPPPPPPPPPPPPPPPPPPPPPPPPPPPPPPPPPPPPPPPPPPPPPPPPPPPPPPPPPPPPPP
PPFPPPPPPPPPPPPPPPPPPPPPPPPPPPPPPPPPPPPPPPPPPPPPPPPPPPPPPPPPPPPPFPPPPF
PPPPPPPPPPPPPPPPPPPPPFPPPPPPPPPPPPPPPPPPPPPPPPPPPPPPPPPPPPPPPPPPPPPPPP
PPPPPPPPPPPPPPPPPPPPPPPPPPPPPPPPPPPPPPPPPPPPPPPPPPPPPPPPPPPPPPPPPPPPPP
PPPPFPPPPPPPPPPPPPPPPPPPPPPPFPPPPPPPPPPPPPPPPPPPPPPPPPPPPPPPPPPPPPPPPP
PPPPPPPPPPPPPPPPPPPPPPPPPPPPPPPPPPPPPPPPPPPPPPPPPPPPPPPPPPPPPPPPPPFPPP
PPPPPPPPPPPPPPPPPPPPPPPPPPPPPPPPPPPPPFPPPPPPPPPPPPPPPPPPPPPPPPPPPPPPPP
PFPPPPPPPPPPPPPPPPPPPPPPPPPPPPPPPPPPPPPPPPPPPPPPPFPPPPPPPPPPPPPPPPPPPF
PPPPPPPPPPPPPPPPPPPPPPPPPPPPPPPPPPPPPFPPPPPPPPPPPPPPPPPPPPPPPPPPPPPPPP
PPPPPPPPPPPPPPPPPPPPPPPPPPPPPPPPPPPPPPPPPPPPPPPPPPPPPPPPPPPPPPPPPPPPPP
PPPPPPPPPPPPPPPPPPPPPPPPPPPPPPPPPPPPPPPPPPPPPPPPPPPPPPPPPPPPPPPPPPPPPP
PPPPPPPPPPPPPPPPPPPPPPPPPPPPPPPPPPPFPPPPPPPPPPPPPPPPPPPFFFPPPPPPPPPPPP
PPPPPPPPPPPPPPPPPPPPPPPPPPPPPPPPPPPPPPPPPPPPPPPPPPPPP*PPPP*PPPPPPPPPPP
