5A03JGN00-ATM4613P22QA1201
1
4052
498
70
65
PPPPPPPPPPP*FPPF*PPPPPPPPPPPPPPPPPPPPPPPPPPPPPPPPPPPPPFFPPPPPPPPPPPPPP
PPPPPFPPPPFPPFPPPFFPPPPPPPPPPPPPPPPPPPPPPPPPPPPPPPPPPFFFFPPPPPPPPPPPPP
PPPPPPPPPPPFPPPFPPPPFFPPPPPPPPPPPPPPPPPPPPPPPPPPPPPPPFFPPPPPPPPPPPPPPP
PPPFPPPPPPFFFPPPPPPPFPPPPPPPPPPPPPPPPPPPPPPPPPPPPPPPPFFPPPPPPPPPPPPPPP
PPPPPPPPPPPPPPPPPPPPPPPPPPPPPPPPPPPPPPPPPPPPPPPPPPPPPFFPPPPPPPFPPPPPPP
PPPPPPPPPFPPPFPPPPPPPPPPPPPPPPPPPPPPPPPPPPPPPPPPPPPPPFFPPPPPPPPPPPPPPP
PFFPPPPPPPPPPPPPPPPPPPPPPPPPPPPPPPPPPPPPPPPPPPFPPPPPPFFPPPPPPPPPPPPPPP
PPPPPPPPPPPPPPPPPPPPPPPPPPPPFPPPPPPPPPPPPPPPPPPPPPPPPFFPPPPPPPPPPPPPPP
PFPPPPPPPPPPPPFPPPPPPPFPPPPPPPPPPPPPPPPPPPPPPPPPPPPPFPPFPPPPPPPPPPPPPP
PPPPPPPPPPPPFFPPPPPPPPPPPPPPPPFPPPPPPPPPPPPPPPPPPPPPPPPPPPPPPPPPPPPPPP
PPPPPPPPPPPPPPFPPPPPPFPPPPPPPPPPPPPPPPPPPPPPPPPPPPPPPPPPPPPPFFPPPPPPPP
PPPPPPPPPPPPPPPFFPPPPPPPPPPPPPPPPPPPPPPFPPPPPPPPPPPPPPPPPPPPPPPPPPPPPP
PPPPPPPPPPPPPPPPPPPPPPPPPPPPPPPPPPPPPPPPPPPPPPPPPPPPPPPPPPPPPPPPPPPPPP
PPPPPPPPPPPPPPPPFPPPPPPPPPPPPPPPPPPPPPPPPPPPPPPPPPPPPPPPPPPPPPPPPPPPPP
PPPPPPPPPPPPPPPPPFPPPPPPPPPPPPPPPPPPPPPPPPPPPPPPPPPPPPPPPPPPFPPPPPPPPP
PFPPPPPPPPPPPPPPPPPPPPPPFPPPPPPPPPPPPPPPPPPPPPPPPPPPPPPPPPPPPPPPPPFPPP
FPPPPPPPPPPPPFPPPPPPPPPPPPPPFPPPPPPPPPPPPPPPPPPPPPPPPPPPPPPPPPPPPPPPPP
FPPPPPPPPPPPPPPPPPPPPPPPPPPPPPPPPPPPPPPPPPPPPPPPPPPPPPPPPPPPPPPPPPPPPP
PPPPPPPPFPPPPPPPPPPPPPPPPPPPPFPPPPPPPPPPPPPPPPPPPPPFPPPPPPPPPPPPPPPPPP
PPPPPPPPPPPPPPPPPPPPPPPPPPPPPFPPPPPPPPPPPPPPPPPPPPPPPPPPPPPPPPPPPPPPPP
PPPPPPPPPPPPPPPPPPPPPPPPPPPPPPPPPPPPPPPPPPPPPPPPPPPPPPPPPPPPPPPPPPPPPP
PPPPPPPPPPPPPPPPPPPPPPPPPPPPPPPPPPPPPPPPPPPPPPPPPPPPPPPPPPPPPPPPPPPPPP
PPPPPPPPPPPPPPPPPPPPPPPPPPPPPPPPPPPPPPPPPPPFPPPPPPPPPPPPPPPPPPPPPPPPPP
PPPPPPPPPPPPPPPPPPPPPPFPPPPPPPPPPPPPPPPPPPPPPPPPPPPPPPPPPPPPPPPPPPPPPP
PPPPPPPFPPPPPPPPPPPPPPPPPPPPPFFFFFFFFFFFFFFFFPPPPPPFFPPPPPPPPPPPPPPPPP
PPPPPPPPPPPPPPPPPPPPPPPPPPPFPFFFFFFFFFFFFFFFFPPPPPPPFFPPPPPPPPPPPPPPPP
PPPPPPPPPPPPPPPPPPPPPPPPFFFFFFFFFFFFFFFFFFFFFPPPPPPPPFFPPPPPPPPPPPPPPP
PPPPPPPPPPPPPPPPPPPPPPPPFFFFFFFFFFFFFFFFFFFFFPPPPPPPPPPPPPPPPPPPPPPPPP
PPFPPPPPPPPPPPPPPPPPPPPPFFFFFFFFFFFFFFFFFFFFFPPPPPPPPPPPPPPPPPPPPPPPPP
PPPPPPPPPPPPPPPPPPPPPPPPFFFFFFFFFFFFFFFFFFFFFPPPPPPPPPPPPPPPPPPPPPPPPP
PPPPPPPPPPPPPPPPPPPPPPPPFFFFFFFFFFFFFFFFFFFFFPPPFPPPPPPPPPPPPPPPPPPPPP
PPPPPFPPPPPPPPPPPPPPPPPPPPPPPFPPFFPPPPPPPPPPPPFFPPPPPPPPPPPPPPPPPPPFPP
PPPPPPPPPPPPPPPPPPPPPPPPPPPPPPPPPPPPPPPPPPPPPPPPPPPPPPPPPPPPPPPPPPPPPP
PPPPPPPPPPPPPPPPPPPFPPPPPPPPPPPPPPPFPPPPPPPPPPPPPPPPPPPPPPPPPPPPPPPPPP
PPPPPPPPFPPFFPPPPPPPPPPPPPPPPPPPPPPPPFFPPPPPPPPPPPPPPPPPPPPPPPPPPPPPPP
PPPPPPPPPPPPPPFFPPPFPPPPPPPPPPPPFPFFPFPPPPPPPPPPPPPPPPPPPPPPPPPPPPPPPP
PPPPPPPPPPPPPPPPPPPPPPPPPPPPPPPPPPPPPPPPPPPPPPPPPPPPPPPPPPPPPPPPPPPPPP
PPPPPPPPPPPPPFPPPPPPPPPPPPPPPPPFPPPPPPPPPPPPPPFPPPPPPPPPPPPPPPFFPPPPPP
PPPPPPPPPPPPPPPPPFFPPPPPPFFPPPPPPPPPPPPPPPPPPPPPPPPPPPPPPPPPPPPPPFPPPP
PPPPPPPPPPPPPPPPPPPPPPPPPPPPPPPPPPPPPPPFFPPFPPPPPPPPPPPPPFPPPPPPPPPPPP
PPPPPPPPPPPPPPPPPPPFPPPPPPPPPPPPPPPPFFPFFFFPPPPPPPFFFFFFPPPPPPPPPPPPPP
PPPPPPPPPPPPPPPPPPPFPPPPPPPPPPPPPPPPPPPFFPPPPPPPPPPPPPPPPPPPPPPPPPPPPP
PPPPPPPPPPPPPPPPPPPPPPPPPPPPPPPPPPPPPPPPPPPPPPPPPPPPPPPPFPPPPPPPPPPPPP
PPPPPPPPPPPPPPPPPPPPPPPPPPPPPPPPPPPPPPPFPPPPPPPPPPPPPPPPPPPPPPPPPPPPFP
PPPPPFFPPPPPPPPPPPPPPPPPPFPPPPFFPFPPPPPPPPPPPPPPPPPPPPPPPPPPPPPPPPPPPP
PPFPPPPPPPPPPPPPPPPPPPPPPPPPPPPPPPPPPPPPPPPPPPPPPPPPPPPPPPPPPPPPPPPPPP
PPPPPPPPPPPPFPPPPPPPPPPPPPPPPPPPPPPPPPPPPPPPPPPPPPPPPPPPPPPPPPPPPPPPPP
PPPPPPPPPPPPPPPPPPFPPPPPPPPPPPPPPPPPPPPPPPPPPPPPPPPPPPPPPPPPPPPPPPPPPP
PPPPPPPPPPPPPPPPPPPPPPPPPPPPPPPPPPPPPPPPPPPPPPPFPPPPPPPPPPPPPPPPPPPPPP
PPPPPPPPPPPPPPPPPPPPPPPPPPPPPPPPPPPPPPPPPPPPPPPPPPPPPPPPPPPPPPPPPPPPPP
PPPPPPPPPPPPPPPPPPPFFPPPPPFPPPPPPPPPPPPPPPPPPPPPPPPPPPPPPPPPPPPPPPPPPP
FPPPPPPPPPPPPPPPPPPPPPPPPPPPPFPPPPPPPPPFPPPPPPPPPPPPPPPPPPPPPPPPPPPPPP
PPPPPPPPPPPPPPPPPPPPPPPPPPPPPPPPPPPPPPPPPPFPPPPPPPPPPPFPPPPPPPFPPPPPPP
PPPPPPPPPPPPPPPPPPPPPPPPPPPPPPPPPPPPPPPPPPPFPPPPPPPPPPPPPPPPPPPPPPPPPF
PPPPPPPPPPPPPPPPPPPPPPPPPPPPPFFFFFFFFFFFFFFFFPPPPPPPPPPPPPPPPPPPPPPPPP
PPPPPPPPPPPPPPPPPPPPPPPPPPPPPPPPPFPPPPPPPPPPPPPPPPPPPPPPPPPPPPPPPPPPPP
PPPPPPPPPPPPPPPPPPPPPPFPPPPPPPPPPPPPPPPPPPPPPPPPPPPPPPPPPPPPPPPPPPPPPF
PPPPPPPPPPPPPPPPPPPPPFFFFFFFFFFFF**FFFFFFFFFFPPPPPPFPPPPPPPPPPPPPPPPPP
PPPPPPPPPPPPPPPPPPPPPPPPFFFFFFFFFFFFFFFFFFFFFPPPPPPPPPPPPPPPPPPPPPPPPP
PPPPPPPPPPPPPPPPPPPPPPPPFFFFFFFFFFFFFFFFFFFFFPPPPPPPPPPPPPPPPPPPPPPPFP
PPPPPPPPPPPPPPPPPPPPPPPPFFFFFFFFFFFFFFFFFFFFFPPPPPPFPPPPPPPPPPPPPPPPPP
PPPPPPFPPPPPPPPPPPPPPPPPFFFFFFFFFFFFFFFFFFFFFPPPPPPPPPPPPPPPPPPPPPPPPP
PPPPPPPPPPPPPPPPPPPPPPPPFFFFFFFFFFFFFFFFFFFFFPPPPPPPPPPPPPPPPPPPPPPPPP
PPPPPFPPPPPPPPPPPPPPPPPPFFFFFFFFFFFFFFFFFFFFFPPPPPPPPFPPPPPPPPPPPPPPPP
PPPPPPPPPPP*PPFF*FFPPPPPFFFFFFFFFFFFFFFFFFFFFPPPPPPPPPPPPPPPPPPPPPPPPP
5A03JGN00-ATM4613P22QA1201
2
4344
206
70
65
PPPPPPPPPPPPPPPPPPPPPPPPPPPPPPPPPPPPPPPPPPPPPPPPPPPPPPPPPPPPPPPPPPPPPP
PPPPPPPPPPPPPPPPPPPPPPPPPPPPPPPPPPPPPPPPPPPPPPPPPPPPPPPPPPPPPPPPPPPPPP
PFPPPPPPPPPPPPPFFPPPPPPPPPPPPPPPPPPPPPPPPPPFPPPPPPPPPPPPPPPPPPPPPPPPPP
PPPPPPPPPPPPPPPPPPPPPPPPPPPPPPPPPPPPPPPPPPPPPPPPPPPPPPPPPPPPPPPPPPPPPP
PPPPPPPPPPPPPPPPPPPPPPPPPPPPPPPPPPPPPPPPPPPPPPPPPPPPPPPPPPPPPPPPPPPPPP
PFPPPPPPPPPPPPPPPPPPPPPPPPPPPPPPFFPPPPPPPPPPPPPPPPPPPPPPPPPPPPPPPPPPPP
PPPPPPPPPPPPPPPPPPPPPPPPPPPPPPPPPPPPPPPPPPPPPPPPPPPPPPPPPPPPPPPPPPPPPP
PPPPPPPPPFFFPFFFPFFPFPFFFPFFPPFFPPPPPPPPPPPPPPPFFFFFPPPPPFPPFPFPPPPPPP
PPPPFFFFFPPPPPPPPPPPPPPPPPFPPPPPPPPPPPPPPPPPPPPPPPPPPPPPPPPPPPPPPPPPPP
PPPPPPPPPPPPFPPPFFPPPPFPPPPPPPPPFFPPPPPFPPPPFPPPPPPPPPPPPPPFPPFPPPPPPP
PPPPPPPPPPPPPPPPPPPPFPPPPPPPPPPPPPPPPFFPPPPPPPPPPPPPPPPPPPPPPPPPPPPPPP
PPPPPPPPPPPPPPPPPPPPPPPPPPPPPPPPPPPPPPPPPPPPPPPPPPPPPPPPPPPPPPPPFPPPPP
PPPPPPPPPPPPPPPPPPPPPPPPPPPPPPPPPPPPPPPPPPPPPPPFFPPPFPPPPPPPPPPPPPPPPP
PPFFPPPPPPPPPPPPPPPPPPFPPFPPPPPPPPPPPFFPPPPPPPPPPPPPPPPPFFPPPPPPPPPPPP
PPPPPPPPPPF*FPPF*PPPPPPPPPPPPPPPPPPPPPPPPPPPPPPPPFPPPPPFFPPFPPPPPPPPPP
PPPPPPPPPPFFPPPPPPPPPPPPPPPPPPPPPPPPPPPPPFPPPPPPPPPPPPPPPPPPPPPPPPPPPP
PPPPPPPPPPPPPPPPPPPPPPPPPPPPPPPPPPPPPPPPPPPPPPPPPPPFFPPPPPPPPPPPPPPPPP
PPPPPPPPPFPPPPPPPPPPPPPPPPPPPPPPPPPPPPPFPPPPPPPPPPPPPPPPPPPFPPPPPPPPPP
PPPPPPPFPPPPPPPPPPPPPPPPPPPPPPPPPPPPPPPPPPPPPPFFPFPPPPPPPPPPPPPPPPPPPP
PPPPPPFPPPPPPPPPPPPPPPPPPPPPPPPPPPPPFPPPPPPPPPFPPPPPPPPPPPFPPPPPPPPPPP
PPPPPPPPPPPPPPPPPPPPPPPPPPPPPPPPPPPPPPPPPPPPPPPPPPPPPPPPPPPFPPPPPPPPPP
PPPPPPPPPPFPPPFPPPPPPPPPPPPFPPPPPPPPPPPPPPPPPPPPPPPPPPPPPPPPFPFFPPPPFP
PPPPPPPPPPPPPPPPPPPPPPPPPPPPPPPPPPPPPPPPPPPPPPPPPPPPPPPPPPPPPPPPPPPPPP
PPPPPPPPPPPPPPPPFPPPPPPPPPPPPPPPPPPPPPPPPPPPPPPPPPPPPPPPPPPPPPPPPPPPPP
PPPPPPPPPPPPPPPPPPPPPPPPPFPPPPPPPPPPPPPPPPPPPPPPPPPPPPPFPPPPPPPPPPPPPP
PPPPPPPPPPPPPPPPPPPPPPPPPPPPPPPPPPPPPFPPPPPPPPPPPFFPPPPPPPPPPPPPPPPPFP
PPPPPPPPPPPPPPPPPPPPPPPPPPPPPPPPPPPPPPPPPPPPPPPPFPPPPPFPPPPPPPPPPPPPPP
PPPPPPPPPPPPFPPPPPPPPPPPPPPPPPPPPPPPPPFPPPPPPPFPPPPPPPPPPPPPPPPPPPPPFF
PPPPPPPPPFPPPPPPPPPPPPPPPPPPPPPFPPPPPPPPPPPPPPPPPPPPPPPFFPPPPPPPPPPPPP
PPPPPPPPPPPPPPPPPPPPPPPPPPPPPPPPPPPPPPPPPPPPPPPPPPPPPFPPPPPPPPPPPPPPPP
PPPPFPPPPPPPPPPPPPPPPPPPPPPPFPPPPPPPPPPPPPPPPPPPPPPPPPPPPPPPPPPPPPPPPP
PPPPPFPPPPPPPPPPPPPPPPPPPPPPPPPPPPPPPPPPPPPPPPPPPPPPPPPPPPPPPPPPFPPPPP
PPPPPPPPPPPPPPPPPPPPPPPPPPPPPPPPPPPPPPPPPPPPPPPPPPPPPPPPPPPPFPPPPPPPPP
PPPPPPPPPPPPPPPPPPPPPPPPPPPPPPPPPPPPPPPPPPPPPPPPPFFPPFPPPPPPPPPPPPPPPP
PPPPPPPPPPPPPPPPPPPPPPPPPPPPPPPPPPPPPPPPPPPPPPPPPPPPPPPPPPPPPPPPPPPPPP
PPPPPPPPPPPPPPPPPPPPPPPPPPPPPPPPPPPPPPPPPPPPPFPPPPPPPPPPPPPPPPPPPPPPPF
PPPPPPPPPPPPPPPPPPPPPPPPPPPPPPPPPPPPPPPPPPPPPPPPPPPPPPPPPPPPPPPPPPPPPP
PPPPPPPPPPPPPPPPPFFPPPPPPPPPPPPPPPFPPPPPPPPPPPPPPPPPPPPPPPPPPPPPPPPPPP
FPPPPPPPFPPPPPPPPPPPPPPPPPPPPPPPPPPPPFFPFPPPPPPPPPPPPPPFPPPPPPPPPPPPPP
PPPPFPPPPPPPPPPPPPPPPPPPPPPPPPPPPFFPPPPPPPPPPPPPPPPPPPPPPPPPPPPPPPPPPP
PPPPPPPPPPPPPPPPPPPPPPPPPPPPPPPPPPPPPFFPPPFPPPPPPPPPPPPPPPPPPPPPPPPPPP
PPPPPPPPPPPPPPPPPPPPPPPPPPPPPPPPPPPPPPFFPPPPPPPPPPPPPPPPPPPPPPPPPPPFPP
PPPFPPPPPPPPPPPPPPPPPPPPPPPPPPPPPPPPPPPPPFPPPPPPPPPPPPPPPPPPPPPPPPPPPP
PPPPPFPPPPPPPPPPPPPPPPPPPPPPPPPPPPPPPPPPPPPPPPPPPPPPPPPPPPPPPPPPPPPPPP
PPPPPPPPPPPPPPPPPPPPPPPPPPPPPPPPPPPPPFFPPPPPPPPPPFFPPPPPPPPPPPPPPPPPPP
PPPPPPPPPPPPPPPPPPFPPPPPPPPPPPPPPPPPPPFPPPPPFPPPPPPPPPPPFPPPPPPPPPPPPP
PPPPPPPPPPPPFPFPPPPPPPPPPPPPFFPPPPPPPPPPPPPPPPPPPPPPPPPPPPPPPPPPPPPPPP
PFPPPPPPPPPPPPPPPPPPPPPPPPPPPPPPPPPPFPPPPPPPPPPPPPPPPPPPPPPPPPPPPPPPPP
PPPPPPPPPPPPPPPPPPPPPPPPPFPPPPPPPPPPPPPPPPPPPPPPPPPPPPPPPPPPPPPPPPPPFP
PPPPPPPPPPPPPPPPPPPPPPPPPPPPPPPPPPPPPPPPPPPPPPPPPPPPPPPPFPPPPPPPPPFPPP
PPPPPPPPPPPPPPPPPPPPPPPPPPPPPPPPPPPPPPPPPPPPPPPPFPPPPPPPFPPPPPPPPPPPPP
PPPPPPPPPPPPPPPPPPPPPPPPPPPPPPPPPPPPPPPPPPPFPPPPPPPPPPPPPPPPPPPPPPPPPP
PPPPPPPPPPPPPPPPPPFPPPPPPPPPPPPPPPPPPPPPPPPPPPPPPPPPPPFPPPPPFPPPPPPPPF
FPPPPPPPPPPFPPPPPPPPPPPPPPPPPFPPPPPPPPPPPPPFFPPPPPPPPFFPPPPPFPPPPPPPPP
PPPPPPPPPPPPPPPPPPPPPPPPPPPPPPPPPPPPPPPPFFPPPPFFPPPPFFPPPPPPPPPPPPPPPP
PPPPPPPPPPPPPPPPPPPPPPPPPPPPPPPPPPPPPPPPPPPPPPPPPPPPPPPPPPPPPPPFPPPPPP
PFPPPPPPPPPPPPPFPPPPPPPPPPPPPPPPPPPPPPPPPPPPPPPFPPPPPPPPPPPPPPPPPPPPPP
PPPPPPPPPPPPPPPPPPPPPPPPPPPPPPPPPPPPPPPPPPPPPPPPPPPPPPPFPPPPPPPPPPPPPP
PPPPPPPPPPPPPPPPPPPPPPPPPPPPPPPPPPFFPPPPPPPPPPPPPPPPPPPPPPPPFPPPPPPPPP
PPPPPPPPPPFPPPPPPPPPPPPPPPPPPPPPPPPPPPPPPPPPPPPPPPPPFPPPPFPPPPPPPPPPPP
PPPPPPPPPPPPFPPPPPPPPPPPPPPPPPPPPPPPPPPPPPPPPPPPPPPPPPPPPPPPPPPPPPPPPP
PPPPPPPPPPPPPPPPPPPPPPPPPPPPPPPPPPPPPPPPPPPPPPPPPPPPPPPPPPPPFFPPPPPPPP
PPPPPPPPPPPPPPPPPFPPPPPPPPPPPPPPPPPPPPPPPPPPPPPPPPPPPPPPPPPPPPPPPPPPPP
PPPPPPPPPFPPPPFFPPPPPPPPPPPPPPPPPPPPPPPPPPPPPPPPPPPFPPPPPPPPPPPPPPPPPP
PPFPPPPPPFPPPPPPPPFPPPPPPPPPPPPPPPPPPPPPPPPPPPPPPPPPPPPPPPPPPPPPPPPPPP
5A03JGN00-ATM4613P22QA1201
3
4352
198
70
65
PPPPPPPPPPFPPPPPPPPPPPPPPPPPPPPPPPPPPPPPPPPPPPPPPPPPPPPPPPPPPPPPPPPPPP
PPPPPPPPPPPPPPPFPPPPPPPPPPPPPPPPPPPPPPPPPPPPPPPPPPPPPPPPPPPPPPPPPPPPPP
PFPPPPPPPPPPPPPPPPPPPPPPPPPPPPPPPPPPPPPPPPPPPPPPPPPPPPPPPPPPPPPPPFPPPF
PPPPPPFPPPPPPPPPPPPPPPPPPPPPPPPPPPPPPPPPPPPPFPPPPPPPPPPPPPPPFPPPPPPPPP
PPPPPPPPPPPPPPPPPPPPPPPPPPPPFPPPFFPPPPPPPPPPPPPPPPPPPPPPPPPPPPPPPPPPPP
PPPPPPFPPPPPPPFPPPPPPPPPFFPPPPPPPPPPPPPPPPPPFPPPPPPPFPPPPPPPPPPPPPPPPF
PPPPPFPPPPPPPPPPPPPPPPPPPPPPPPPPPPPPPPPPPPPPPPPPPPPPPPPPPPPPPPPPPPPPPP
PPPPPPPPPPPPPPPPPPPPPPPPPPPPPPPPPPPPPPPPPPPPPPPPPPPPPPPPPPPPPPPPPPPPPP
PPPPPPPPPPPPFPPPPPPPPPPPPPPPPPPPPPPPPPPPPPPPPPPPPPPPPPPPPPPPPPPPPPPPPP
PPPPPPPPPPPPPPPPPPPPPPPPPPPPPPPPPPPPPPPPPPPPPPPPPPPPPPPPPPPPPPPPPPPFFP
PPPPPPPPPPPPFPPPPPPPPPPPPPPPPPPPPPPPPPPPPPPPPFPPPPPPPPPPPPPPPPPPPPPPPP
PPPPPPPPPPFPPPPPPPPPPPPPPPPPPPPPPPPPPPPFPPPPPPPPPPPPPPPPPPPPPPPPPPPPPP
PPPPPPPPPPFFPPPPPPPPPPPPPPPPPPPPPFPPPPPPPPPPPPPPPPPPPPPPPPPPPPPPPPPPPP
PPPPPPPPPPPPPPPPPPPPPPPPPPPPPPPPPPPPPPPPPPPPPPPPPPPPPPPPPPPPPPPPPPPPPP
PPPPPPPPPPPFFPPPPPPPPPPPPPPPPPPPPPPPPPPPPPPPPPPPPPPPPPPPPPPPPPPPPPFPPP
PPPPPPPPPPPPPPFPPPPPPPPPPPPPPPPPPPPPPPPPPPPPPPPPPPPPPPPPPPPPPPPPPPFPFP
PPPPPPPPPPPPPPPPFFPPPPPPPPPPPPPPPFPPPPPPPPPPPPPPPPPPPFFPPPPPPPPPPPPPPP
PPPPPPPPPPPPPPPPPPPPPPPFPPPPPPPPPPPPPPPPPPPPPPPPPPPPPPPPPPPPPPPPPPPPPP
PPPPPPPPPPPPPPPFPPFPPFFPPPPPPPPPPPPPPPPPPPPPPPPPPPPPPPPPPFPPPPPPPPPPPP
PPPPPFPPPPPPPPPPPPPPPPPPPPPPPPPPPPPPPPPPPPPPPPPFPFPPPPPPPPPPPPPPPPPPFF
PPPPPPPPPPPFPPPPPPPPPPPPPPPPPPPPPPPPPPPPPPPPPPPPPPPFPFPPPPPPPPPPPPFPPP
PPPPPPPPPPPPPPPFPPPPPPPPPPPPPPPPPPPPPPPPPPPPPPPPPPPPPPPPPPPPPPPPPPPPPF
PFPPPPPPPPPPPPPPPPPPPPPPPPPPPPPPPFPPPPPPFPPPPPPPPPPPPPPPPFPPPPPPPPPFPP
FPPPPPPPPPPFPPPPPPPPPPPFFPPPPPPPPPPPPFPPPPPPPPPPPPPPPPPPPPPPPPPPPPPPPP
PPPPPFPPPPPPPPPPPPPPPPPPPPPPPPPPPPPFPPPPPPPPPPPPPPPPPPPPPPPPFPPPPPPPPP
FPPPPPPPPPPPPPPPPPPPPPPPPFFPPPPPPPPPPPPPPFFPPPPPPPPPPPPPPPPPPPPPPPPPPP
FFPPPPPPPPPPPPPFPPPPPPPPPPPPPPPPPPPPPPPPPPPPPPPPPPPPPPPPPPPPPPPPPPPPPP
PPPPPPPPPPPPPPPPPFPPPPPPPPPPPPPPPPPPPPPPPPPPPPPPPPPFFPPPPPPPPPPPPPFFPP
PPPPPPPPPPPPPPPPPPPPPPPPPPPPPPPPPPPPPPPPPPPPPPPPPPPPPPPPPPPPPPPPPPPPPP
FFPPPFPPPPPPPPPPPPPPPPPPPPPPPPPPPPPPPPPPPPPPPPPPPPPPPPPPPPPPPPPPPPPPPP
PPPPPPPPPPPPPPPPPPPPPPPPPPPPPPPPPPPPPPPPPPPPPPPPPPPPPPPPPPPPPPPPPPPFPP
PPPPPPPPPPFPPPPPPPPPPPPPPPPPPPPPPPPPPPPPPPPPPPPPPPPPPPPPPPPPPPPFFPPPPP
PPPPPPPPPPPPPPPPPPPFPPPPPPFPPPPPPPPPPPPPPPPPPPPPPPPPPPPPPPPPPPPPPPPPPP
FPPPPPPPPPPPPFPPPPPPPPPPPPPPPPPPPPPPPPPPPPPPPPPPPPPPPPPPPPPPPPFPPPFPFP
PPPPPPPPPPPPPPFFPFPPPPPPPPPPPPPPPPPPPPPPPPPPPPPPPPPPPPPPPPPPPPPPPPPPPP
PPPPPPPPPPPPPPPPPPPPPPPPPPPPPPPPPPPPPPPPPPPPPPPPPPPPPPPPPPPPPPPPPPPPPP
PPPPPPPPPPPPPPPPPPPPFPPPPPPPPPFPPPPPPPPPPPPPPPPPPPPPPPPPPPPPPPPPPPPPPF
PPPPPPPPPPPPPPPPPPPPPPPPPPPPPPPPPPPPPPPPPPPPPPPPPPPPPPPPPPPPPPPPPFPPPP
PPPPPPPPPPPPPPPPPPPPPPPPPPPPPPPPPPPPPPPPPFPPPPPPPPPPPPPPPPPPPPPPPPPPFP
PPPPPPPPPPPPPPPPPPPPPPPPPPPPPPPPPPPPPPPPPPPPPPPPPPPPPPPFFPPPPPPPPPPPPP
PPPPPPFPPPPPPPPPPPPPPPPPPPPPPPPPFFPPPPPPPPPPPPPPPPPPPPPPPPPPPPPPPPPPPP
PPPPPPPPPPPPPPPPPPPPPPPPPPPPPPPPPPPPPPPPPPPPPPPPPPPPPPPPPPPPPPPPPPPPPP
PFPPPPPPPPPPPPPPPPPPPPPPPPPPPPPPPPPPPPPPPPPPPPFFPPPPPPPPPPPPPPPPPPPPPP
PPPPPPPPPPPPPPPPPPPPPPPPPPPPPPFPPPPPPPPPPFPPPPPPPPPPFPPPPPPPPPPPPPPPPP
PPPPPPPFPPPPPPPPPPPPPPPPPPPPPPPPPPPPPPPPPPPPPPPPPFFPPPPPPPPPPPPPPPPPFP
PPPPPPPPPPPPPPPPPPPPPPPPPPPPPPFPPPPPPPPPPPPPPPPPPPPPPPPPPPPPPPPPPPPPPP
PPPPPPPPPPPPPPPPPPPPPPPPPPPPPPPPPPPPPPPPPPFPPPPPPPFPPPFFPPPPPPPPPPPPPP
PPPPPPPPPPPPPPPPPPPPPPPPPPPPPPPPPPPPPPPPPPPPPPPPPPPPPPPPPPPPPFFPPPPPPP
PPPPPPPPPPPPPPPPPPPPFPPPPPPPPPPPPPPPPPPPPPPPPFFPPPPPPPPPFFPPPPPPPPFFPP
PPPPPPPPPPPPPPPPPPPPPPPPPPPPPPPPPPPPPPPPPFPPPPPPFFFPPPPPPPPPPPPPPPPPPP
PFPPPPPPPFF*FFFF*FFPPPPPPPPPPPPPPPPPPPPPPPPPPPPPPPFFFPPPPPPPPPPPPPFPPP
PFPPPPPPPPPPPPPPPPPPPPPPPPPPPPPPPPPFPPPPPPPPPPPPPPPPPPPPPPPPPPPPPPPPPP
PPPPPPPPPPPPPPPPPPPPPPPPPPPPPPPPPPFFPPPPPPPPPFPPPPFFPPPPPPPPPPPPPPPPPP
PPPPPPPPPPPPPPPPPPPPPPPPPPPPPPPFPPFPPPPPPPPFPPPPPPPPPPPPPPPPPPPPPPPPFP
PFPPFPPPPPPPPPPPPPPPPPPPPPPPPPPPPPPPPPPPPPPPPPPPPPPPPPPPPPPPPPPPPPPPPP
PPPPPPPPPPPPPPPPPPPPPPPPPPPPPPPPPPPPPPPPPPPPPPPPPPPPPPPPPPPPPPPPFPPPPP
PPPPPPPPPPPPPPPPPPPPPPPFPPPPPPPPPPPPPPPPPPPPPPPPPPPPPPPPPPPPPPPPPPPPPP
FPPPPPFFPPPPPPPPPPPPPPPPPPPPPPPPPPPPPPPPPPPPPPPPPPPPPPFFPPPPPPPPPPPPPP
PPFPFFPPPPPPPPPPPPPPPPPPPPPPPPPPPPPPPPPPPPPPPPPPPPPPPPPPPPPPPFPPPPPPPP
PPPPPPPPPPPPPPPPPPPPPPPPPPPPPPPPPPPPPPPPPPPPPPPPPPPPPPPPPPPPPPPPPPPPPP
PPPPPPPPPPPFFPPPPPFFPPPPPPPPPPPPPPPPPPPPPPPPPPPPPPPPPPPPPPPPPPPPPPPPPF
PPPPPPPPPPPPPPPPPPPPPPPPPPPFPPPPPPPPPPPPPPPPPPPPPPPPFFPPPPPPPPPPPPPPPP
PPPPPPPPPPPPPPFPPPPPPPPPPPPPPPPPPPPPPPPPPPPPPPPPPPPPPPFPPPPPPPPPPPPPPP
PPPFPPPPPPPPPPPPPPPPPPPPPPPPPPPPPPPPPPPPPPPPPPFPPPPPPPPPPPFPPFFPPPPFPP
PPFPPPPPPFPPPPPPPPPPPPPPPPPPPPPPPPPFFPPPPPPPPPPPPPPPPPPPPPPPPPPPPPPPPP
5A03JGN00-ATM4613P22QA1201
4
4395
155
70
65
PPPPPPPPPPPPPPPPPPPPPPPPPPPPPPPPPPPFPPPPPPPPPPPPPPPPPPPPPPPPPPPPPPPPPP
PPPPPPPPPPPPPPPPPPPPPPPPPPPPPPFPPPPFPPPPPPPPPPPPPPPPPPPPPPPPPPPPPPPPPP
PPPPPPPPPPPPPPPPPPPPPPPPPPPFPPPPPPPPPPPPPPPPPPPPPPPPPPPPPPPPPPPPPPPPPP
PPPPPPPPPPPPPFFPPPPPPPPPPPPPPPPPPPPPPPPPPPPPPPPPPPPPPPPPPPPPPPPPPPPPPF
FPPPPPPPPPPPPPPPPPPPPPPPFPPPPPPPPPPPPPPPPPPPPPPPPPPPPPPPPPPPPPPPPPPPPP
PPPFPPPPPPPPPPPPPPPPPPPPPPFPPPPPPPPPPFPPPPPPPPPPPPPPPPPPPPPPPPPPPPPPPP
PPPPFPPPPPPPPPPPPPPPPPPPFFPPFFFPPPPPPPPPPPPPPPPPPPPPFFPPPPPPPPPPPPPPPP
PPPPPPPPPPPPPPPPPPPPPPPPPPPPPPFPFPPPPPPPPPPPPPPPPPPPPPPPPPPPPPPPPPPPPP
PPPPPPPPPPPPPPPPPPPPPPPPPFPPPPPPPPPPPPPPPPPPPFPPPPPPPPPPPPPPPPPPPPPPPP
PPPPPPPPPPPPPPFPPPPPPPPPPFFPPPPPPPPPPPPPPPPPPPPPPPPPPPPPPPPPPPPPPPPPFP
PPPPPPPPPPPPPPPPPPPPPPPPFPPPPPPPPPPPFFPPPPPPPPPPPPPPPPPFPPPPPPPPPPPPPP
PPPPPPPPPPPPPPPPPPPPPPPPPPPPPPPPPPPPPPPPPPPPPPPPPPPPPPPPPPFPPFPPPPPPPP
PPPPPPPPPPPPPPPPPPPPPPPPPPPPPPPPPPPPPPPPPPPPPPPPPPFPFPPPPPPPPPPPPPPPPP
PPPPPPPPPPPPPPPPPPPPPPPPPPPPPFPPPPPPPPPPPPPPPPPPPPPPPPPPPPPPPPPPPPPPPP
PPPPPPPPPPPPPPPPPPPPPPPPPPPPPPPPPPPPPPPPPPFFPPPFFPPPPPPPPPPPPPPPFPPPPP
PPPPPPPPPPPPPPPPPPPPPPPPPPPPPPPPPPPPPPPPPPPPPPPPPPPPPPPPPPPPPPPPPPPPPP
PPPPPPPPPPPPPPPPPPPPPPPPPPPPFFPPPPPPPPPPPPPPPPPPFPPPPPPPPPPPPPPPPPPPPP
PFPPPPPPPPPPPPPPPPPPFPPPPPPPPPPPPPPPPPPPPPPPFPPPPPPPFPPPPPPFPPPPPPPPPP
PPPPPPPPPPPPPPPPPFPPPPPPPPPPPPPPPPPPPPPPPPPPPPPFPPPPPPFPPPPPPPPPPPPPPP
PPPPPPPPPPPPPPPPPPFPPPPPPPPPPPPPPPPPPPPPPPPPPPPPPPPPPPPPPPPPPPPPPPPPPF
PPPPPPPPPPPPPPFPPPPPPPPPPPPPPPPPPPPPPPPPPPPPPPPPPPPPPPPPPPPPPPPPPPPPPP
PPPPPPPPPPPPPPPPPPPPPPPPPPPPPPPPPPPPPPPFPPPPPPPPPPPPPPFPPPPPPPPPPPPPPP
PPPPPPPPPPPPPPPPPPPPPPPPPPPPPPPPPPPPPPPPPPPPPPPPPPPPPPPPPPPPPPPPPPPPPP
PPPPPPPPPPPPPPPPPPPPPPPPPPPPPPPPPPPPPPPPPPPPPPPPPPPPPPPFFPPPPPPPPPPPPP
PPPPPPPPPPPPPPPPPPPPFPFPPPPPFPPPPPPPPPPPPPPPPPPPPPPPPPPPPPPPPPPPFPPPPP
PPPPPPPPPPPPPPPPPPPPPPPPPPPPPPPPPPPPPPPPPPPPPPPPPPPPPPPPPFPPPFPPPPPPPP
PPPPFPPPPPPPPPPPPPPPPPPPPPPPPPPPPPPPFPPPPPPPPPPPPPPPPPPPPPPPPPPPPPPPPP
PPPPPPPPPPPPPPPPPPPPPPPPPPPPPPPPPPPPPPPPPPPPPPPPPPPPPPPPPFFPPPPPPPPPPP
PPPPPPPPPPPPPPPPPPPPPPPPPPPPPPPPPPPPPPPPPPPPPPPPPPPPPPPPPPPPPPPPPPPFPP
PPPPPFPPPPPPPPPPPPPPPPPPPPPPPPPPPPPPPPPPPPPPFPPPPPPPPPPPPPPPPPPPPPPPPP
PPPPPPPFPPPPPPPPPPPPPPPPPPPPPPPPPPPPPPPPPPPPPPPPPPPPPPPPPPFPPPPPPPPPPP
PPFPPPPPPPPPPPPPPPPPPPPPFPPPPPPPPPPPPPPPPPPPPPPPPPPPPPPFFPPPPPPPPPPPFP
PPPPPPPPPPPPPPPPPPPPPPPPPPPPPPPPPPPPPPPPPPPPPPPPPPPPPPPPPPPPPPPPPPPPFP
PPPPPPPPPPPPPPPPPPPPPPPPPPPPPPPPPPPPFPPPPPPPPPPPPPFPFPPPPPPPPPPPPPPPPF
PPPPPFPPPPPPPPPPPPPPPPPPPPPPPPPPPPPPPPPPPPPPPPPPFPPPPPPPPPPPPPPPFPPPPP
PPPFPPPPPPPPPPPPPPPPPPPPPPPPPPPPPPPPPPPPPPPPPPPPPPPPPPFPPPPPPPPPPPPPPP
PPPPPPPPPPFPPPPPPPPPPPPPPPPPPPPPPPPPPPPPPPPPPPPFFPPPPPPPPPPPPPPPPPPFFP
PPPPPPPPPPPPPPPPPPPPPPPPPPPPPPPPPPPPPPFPPPPPPPPPPPPPPPPPPPPPPPPPPPPPPP
PPPPPPPPPPPPPPPPPPPPPPPPPPPPPPPPPPPPPPPPPPPPPPPPPPPPPPPPPPPPPPPPPPPPPP
PPPPPPPPPPPPPPPPPPPPPPPPPPPPPPFPPPPPPPPPPPFPPPPPPPPPPPPPPPPPPPPPPPPPFF
PPPPPPFPPPPPPPPPPPPPPPPPPPPPPPPPPPPPPPPPPPPPPPPPPPPPPPPPPPPPPPPPPPPPPP
PPPPPPPPPPPPPPPPPPPPPPPPPPPPPPPPPPPPPPPPFFPPPPPPPPPPPPPPPPPPPPPPPPFPPP
PPPPPPPPPPPPPPPPPPPPPPPPPPPPPPPPPPPPPPPPPPPPPPPPPPPPPPPPPPPPPPPPFPPPPP
PPPPPPPPPPPPPPPPPPPPPPPPPPPPPPPPPPPFPPPPPPPPPPPPPPPPPFPPPPPPPPPPPPPPPP
PPPPPPPPPPPPPPPPPPPPPPPPPPPPPPPPPPPPPPPPPPPPPPPPPPPPPPPPPPPPPPPPPPPPPP
PPPPPPPPPPPPPPPPPPPPPPPPPPPPPPPPPPPPPPPPPPPPPPPPPPPPPPPPPPPPPPPPPPPPPP
PPPPPPPPPPPPPPPPPPPPPPPPPPPPPPPPPPPPPPPFFPPPPPPPPPPPPPPPPPPPPPPPPPPPPF
PPPPPPPPPPPPPPPPPPPPPPPPPPPPPPPPPPPPPPPPPPPPPPPPPPPPPPPPPPPPPPPPPPPPPP
PPPPPPPPPPPPPPPPPPPPPPPPPPPPPPPPPPPPPPFFPPPPPFPPPPPPPPPPPPPPPFPPPPPPPP
PPFPPPPPPPPPPPPPPPPPPPPPPPPPPPFFPPPPPPPPPPPPPPPPPPPPPPPPPPPPPFPPPPPPPP
PPPPPPPPPPPPPPPPPPPPPPPPPPPPPPPPPPPPPPPPPPPPPPPPPPPPPPPPPPPPPFPPPPPPPP
PPPPPPPPPPPPPPPPPPPPPPPPPPPPPPPPPPPPPPPPFPPPPPPPPPPPPPPPPPPPPPPPPPPFFP
PFPPPPPPPPPPPPPPPPPPPPPPPPPPPPPPPPPPPPPPPPPPPPPPPPPPPPPPPPPPPPPPPPPPPP
PFFPPPPPPPPFPPPPPPPPPPPPPPPPPPPPPPPPFPPPPPPPPPPPPPPPPPPPPPPPPPPPPPPPPP
PPPPPPPPPPPPPPPPPPPPPPPPFPPPPPPPPPPPPPPPPPPPPPPPPPPPPPPPPPPPPPPPPPPPPP
PPPPPPPPPPPPPPPPPPPPPPPPPPPPPPFPPPPPFPPPPPPPPPPPPPPPPPPPPPPPPFPPPPPPPP
PPPPPFPPPPPPPPFPPPPPPPPPPPPPPPPPPPPPPPPPPPPPPPPPFFPPPPPPPPPPPPPPPPPPPP
PPPPPPFFPPPPPPPPPPPPPPPPPPPPPPPPPPPFFPPPPPPPPPPPPPPPPPPPPPPPPPPPPPPPPP
PPPPPPPPPPPPPPPPPPPPPPPPPPPPPPPPPPPPPPPPPPPPPPPPPPPPFPPPPPPPPPPPPPPFPP
PPPPPPPPPPPPPPPPPPPPPPPPPPPPPPPPPPPPPPPPPPPPPPPPPPPPPPPPPPPPPPPPPPPPPP
PPPPPPPPPPPPPPPPPPFPPPPPPPPPPPPPPPPPPPPPPPPPPPPPPPPPPPPPPPPPPPPPPFFPPF
PPPPPPPPPPPPPPPPPPPPPPPPPPPPPPPPPPPPPPPPPPPPPPPPPPPPPPPPPPPPPPPPPPFFPP
PPPFPPPPPPPPPPPPPPPPPPPPPPPPPPPPPPPPPPPPPPPPPPPPPPPPPFPPPPPPPPPPFPPPFF
PPPPPPPPPPPPPPFPPPPPPPPPPPPPPPPPPPPPPPPPPPPPPPPPPPPPPFPPPPPPPPPPPPPPPP
PPPPPPPPPPFPPPPPPPPPPPPPPPPPPPPPPPPPPPPPPPPPPPPPPPPPPPPPPPPPPPPPPPPPPP
