5A03JGN00-ATM4614P21QA2201
1
4250
300
70
65
PPPPPPPPFFF*FFFF*FFPPPPPPPPPPPPPPPPPPPPPPPPPPPPPPPPPPPPFPPPPPPPPPPPPPP
FPPFPPPPPPPPFFPPFFPFFFPFPPPPPFFPPPPPPPPPPPPPPPPPFPPPPPFPPPPPFPPPPPPPPP
FPFFFPPPPPPPPPPPPPPPPPPPPPPPPPPPPPPPPPPFFPPPPPPPPPPPPPPPPPFFPPPPPPPPPF
PPFFPPPPPPPPPPPPPPPPPPPPPPPPPPPPPPPPPPPPPPPPPPPPFFFPPPPFFFPPPPPPPPPPPP
FPPPPFPFPPFPPPPPPPPPPPPPPPPPPPPPPPPPFFPFPFPPFPPPPPPPPPPPPPPPPPPPPPPPPP
PPPPPPPPPPPPPPPFPPPPPPPPPPPPPPPPPPPPFPPPPPPPPPPPPPPPPPPPPPPPPPPPPPPPPP
PPPPPPPPPPPPPPPPPPPPPPPPPPPPPPPPPPPPPPPPPFPFPPPPPPPPPFPPPPPPPPPPPPPPPP
PPPPPPPPPPPPPPPPPPPPPPPPPPPPPPPPPPPPPPPPPFFPPPPPPPPPPPPPPPPPPFPPPPPPPP
FFPPPPPPPFPPPPPPPPPPPPPPPPPPPPPPFFPPPPPPPPPPPPPPPPPPPPPPPPPPPPPPPPPPPP
PPPPPPPPPPPPPFFPPPPPPPPPPPPPPPPPPPPPPPPPPPPPPPPPPPPPFPPPPPPPPPPPPPPPPP
PPPPPPPPFPPPPPPPPPPPPPPPPPPPPPPPFPPPPPPPPPPPPPPPPPPPPPPPPPPPPPPPPPPPPP
PFFPPPPPPPPPPPPPPPPPPPPPPPPPPPPPPPPPPPPPPPPPPPPPPPPPPPPPFFFPPPPPPPPPPP
PPPPFFPPPPPFFPPPPPPPPPPPPPPFPPPPPPPFFFFPPPPPPPPPPPPPPPFPPPPPPPPPPPPPFF
FPPPPPPPPPPPPPPPPPPPPFPPPPPPPPPPPPPPPPPPPPPPPPPPPPPPPPPPPPPPPPPPPFFPPP
FFPPPPPPPPPPPPFPFPPPPPPPPPFPFFPPPF*PFFPPPPPPPFFFFFFPPPPPFPPPPPPPPPPPPP
PPPPPPPPPPPPPPPPPPPPPPPPPPPPPPPPFPPPPPPFFPPPPPPPPPPPPFPPPPPPPPPPPPPPPP
PPPPPPPPPFPPPPPPPPPPPPPPPPPPPPPPPPPPPPPPPPPPPPPPPPPPPPPPPPPPPPPPPPPPPP
PPPPPPPPPPPPPPPPPPPPPFPPPPPPPPPPPPPPPPPPPPPPPPPPPPPPPPPPPPPPPPPPPPPPPP
PPPPPPPPPPPPPPPPPPPPPPPPPPPPPPPPPPPPPPPPFPPPPPPPPPPPPPPPPPPPPPPPPPPPPP
PFPPPPPPFPPPPPPPPPFPPPPPPPPPPPPPPPPPPPFPPPPPPFPPPPPPPPPPPPPPPPPPPPPPPP
PPPPPPPPPPPPPPPPPPPPPPPPPPPPPPPPPPPPPPPPPPPPPPPPPPPPPPPPPFPPPPPPPPFPPP
PPPPPPPPPPPPPPPPPPPPPPFPPPPPPPPPPPPPPPPPPPPPPPPPFFPPPPPPPPPPPPPPPPPPPP
PPPPPPPPPPPPPPPPPPPPPPPFPPPPPPPFPFPFPPPPPPPPPPPPPPPPPPPPFPPPPPPPPPPPPP
PPPPPPPPPPPPPPPPPPFPPPPPPPPPPPPPPPPPPPPPPPPPPPPPPPPPFFPPPPPPPPPPPPPPPP
PPFPPPPPPPPPPPPPPFPPPPPPPPPPPPPPFFPPPPPPPPFPPPPPPPPPPPPPPPPPPPPPPPPPPP
PPPPPPPPFPPPPPPPPPPFPPPPPPPPPPPPPPPPFPFPPFPPPPPPPPPPPPPFPPPPPPPPPPPPPP
FPPPPPPPPPPPPPPPPPPPPPPPPPPPPPPFPPPPPPPPPPPPPPPPPPPPPPPPPPFPPPPPPPPPPP
PPPPPPPPPPFPPFPPPPPFPPPPPPPFFPPPPPPPFPPPPPFPPPFPPPPPPPPPPPPPPPPPPPPPPP
PPPPPPPPPPPPPPPPPPPPPPFPPPPPPPPPPPPPPPPPPPPPPPPPPPPFPPPPPPPPPPPPPPPPPP
PFPPFPPPPPPPPPPPPPPPPPPFFPPPPPPPPPPPPPPPPFPPPPPPPPPPPPPPPPPPPPPPPPPPPF
PPPPPPPPPPPPPPPPPPPPPPPPPPPPFFPPPPPPPPPPPPPPPPPPPPPPPPPPFPPFFPPPFPPPPP
PPPPPPPPPPPPPPPPPPPPPPPPPPPPPPPPPPPPPPPPPPPPPPPPPPPPPPPPPPPPPPPPPPPPPP
PPPPPPPPPPPPPPPPPPPPPPPPPPPPPPFPPPFPPPPPPPPPPPPPPPPFFPPPPPPPPPPPPPPPPP
PPPPPPPPPPPPPPPPPPPPPPPPPPPPPPPPPPPPFFPPPPPPPPPPPPPPPPPPPPPPPPPPPPPPPP
PPPPPPPPPPPPPPPPPPPPPPPPPPPPPPPPPPPPPPPPPPPPPPPPPPPPPFPPPPPFPPPFFPPPPP
PPFPPPPPPPPPPPPPPPPPPPPPPPPPPPPPPPPPPPPPPPPPPPPPPPPPFFPPPPPPPPPPPPPPPP
PPPPPPPPPPPFFPPPPPPPPPPPPPPPPPPPPPPPFFPPFFFPPPPPPPPPPPPPPPPPPPPPPPPPPP
PPPPPPPPPPPPPPPPPPPPPPPFPPPPPPPPPPPPPPFPFPFFPPPPPPPPPPPPPPPPPPPPPPPPPP
PPPPPPPPPPFPPPPPPPPPPPPPPPPPPPPPPPPPPPPPPPPPPPPPPPPPPPPPPPPPPPPFFPPPPP
PPPPPPPPPPPPPPPPPPPPPPFFPFPPPPPPFPFFPPFPPPPPPPPPPPPFFFPPPPPPFPPPPPPPPP
PPPFPPPPPPPPPPPPPPPPPPPPPPPPPPPPPPPPPPPPPFPPPPPPPPPPPPPPPPPPFPPPPPPPPP
PPPPPPPPPPPPPPPPPPPPPPPPPPPPPPPPPPPPPPPPPPPPFPPPPPPPPPPFFPPPPPPPPPPPPP
PPPPPPPPPPPPPPPPPPPPPPPPPPPPPPPPPPPPPPPPPPPPPPPPPPPPPPPPPPPPPPPPPPPPPP
PPPPPPPPPPPPPPPPPPPPPPPPPPPPPPPPPPPPPPPPPPPPPPPPPPPPPPPPPPPPPPPPPPPPPP
PPPPPPPPPPPPPPPPPPPPPPPPPPPPPPPPPPPPPPPPPPPPFPPPPPPPPPPPFPPPPPPPPPPPPP
PPPPPPPPPPPPPPPPPPPPPPPPPPPPPPPPPPPPPPPPPPFPPPPPPPPPPPPPPPPPPPPPPPPPPP
PPPPPPPFPPFPPPPPFPPPPPPFFPPPPPPPPPPPPPPPPPPPPPPPPPPPPPPPPPPPPPPPPPPPPP
PPPFPPPPPPPPPPPPPPPPPPPPPPFPPPPPPPPPPPPPFPPPPPPPPPPPPPPPPPPPFPPPPPPPPP
FPPPPPPPPPPPPPPPPPPPPPPPPPPPPPPPPPPPPPPPPPPPPFPFFPFFPPPPPPPPPPPPPPPPPP
FPPPPPPPPPPPPPPPPPPPPFPPPPPPPPPPPPPPPPPPPFPPPPPPPPPFPPPPPFPPPPPPPPPPPP
PPPPPPPPPPPPPPPPPPPPPPPPPPPPPPPPPPPPPPPPPPPPPPPPPPPPPPPPPFPPPPPPPPPPPP
PPPPPPPPPFFPPPPPPPPPPPPPPPPPPPFFPPPPPPPPPPPPPPPPPPPPPPPPPPPPPPPPPPPPPP
PPPPPPPPPFPPPPPPPPPPPPPPPPPPPPPPPPPPPPPPPPPPPPPPPPPPPPPPPPPPPPPPPPPPPP
PPPPPPPPPPPPPPPPPPPPPPPPPPPPPPPPPFPPPPPPPPPPFPPPPPPPPPPFPPPPPPPPPPPPPP
PPPPPPPPPPPPPPPPPPPPPPPPPPPPPPPPPPPPPPPPPPPPPPPPPPPPPPPPPPPPPPPPPPPPPP
PPPPPPPPPPPFPPPPFFPPPPPPPPPPPPPPPPPPPFPPPPPPPPFPPPPPPPPPPPPPPPPPPPPPPP
PPPPPPPPPPPPPPPPPPPPPPPPPPFPFPPPPPPPPPPPPPPPPPPPPPPPPPPPPPPPPPPPPPPPPP
PPPPPPPPPPPPPPPPPFPPPPPPPPPPPPPPPPPPPPPPPPPPPPPPPPPPPPPPPFFPPPPPPPPPPP
PPPPPPPPPPPPPPPPPPPPPPPPPPPPPPPPPPPPPPPFPPPPPPPPPPPPPPPPPPPPPPPPPPPPFP
PPPPPPPPPPPPFFPPPPPPPPPPPPPPPPPPFPFPPPPPPPPPPPPFPPPFFPPPPPPPPPPPPPPPPP
PPPPPPPPPPPPPFFPPPFPPPPPPPPPPPPPPPFPPPPPPPPPPPPPPPFPFPPPPPPPPFPPPPPPPP
FPPPPPPPPPPPPPPPPPPPPPPPPPPPPPPPPPPPPPPPPPPPPPPPPPPPPPPPPPPPPPPPPPPPPF
PPPPPPPPPPPPPPPPPPPPPPPPPPPPPPPPPPPPPPPFPPPPPPPPPPPPPPPPPPPPPPPPPPPPPP
PPPPPPPPFFPPPFFPPFFFPPFFPPPPPPPPPPPPPPPFPPPPPPPPPPPPPPPPPPPPPPPPPPPPPP
PPPPPPPPPFF*FFFF*FFPPPFPPPPPPPPPFFPPPPPPPPPPPPPPPPPPPPPPPPPPPPPPPPPPPP
5A03JGN00-ATM4614P21QA2201
2
4287
263
70
65
PPPPPPPPPFPFPPPPPPPPPPPPPPPPPPPPPPPPPPPPPPPPPPPPPPPPPPPPPPPPPPPPPPPPPP
PPPPPPPPPPPPPPFFPPPPPPPFPPPPPPPPPPFPPPPPPFFPPPPPPPPPPPPPPFPPPPPPPPPPPP
PPPPPPPPPPPFPPPPPPPPPPPPPPPPPPPPPPPPPPPPPPPPPPPPPPPPPPPPPPFPPPPPPPPPPP
PPPPPPPPPPPPPPPPPPPPPPFPPPPPPFPPPPPPPPPPPPPPPPFPPFFPPPPPPPPPPPPPPPPPFP
PPPPPPPPPPPPPPPPPPPPPPPPPPPPPPPPPF*FPPPPPPPPPPPPPPPPPPPPPPPPPPPPPPPPPP
PPPPPPFPPPPPPPPPPPPPPPPPFPPPPPPPPF*FPPPPPPPPPPPPPPPPPPPPPPPPPPPPPPPPPP
PPPPPPPPPPPPFPFPPFFPPPPPPPPPPPPPPP*PPPPPPPPPPPPPPPPPPPPPPPPPPPPPPPPPPP
PPPPPPPPPPPPPPFPPPPPPPPPPPPPPPPPPF*FPPPPPPPPPPPPPPPPPPPPPPPPPPPPPPPPPP
PFPFPPPPPPPFPPPPPPPPPPPPPPPPPPPPPP*FFPPPPPPPPPPPPPPPPPPPPPPPPPPPPPPPPP
PPPPPPFPPPPPPPPPPPPPPFPPPPPPPPPPPF*FPPPPPPPPPPPPFPPPPPPPPPPPPPPPPPPPPP
PPPPPPPPPPPPPPPPPPPPPPPPPPPPPPPPPF*PPPPPPPPPPPPPPPPPPPPPPPPPPPPPPPPPPP
PPPPPPPPPPPPPPPPPPPPPPPPPPPPPPPPPP*PPPPPPPPPPPPPPPPPPPPPPPPPFPPPPPPPPP
PPPPPPPPPPPPPPPPPPPPPPPPPPPPPPPPPF*FPPPPPPPPPFPPPPPPPPPPPPPPPPPPPPPPPP
PPPPPPPPPPPPPPFPPPPPPPPPPPPPPPPPPF*FPPPPPPPPPPPPFPPPPPPFFFPPPPPPPPPPPP
PFPPPPPPFPF*FFPF*PPPPPPPPPPPPPPFPPPPPPPPPPPPPPPPPPPPPPPPPFPPPPPPPPPPPP
PPPPPPPPPPPPPPPPPPPPPPPPPPPPPPPPPPPPPPPPPPPPPPPPPPPPPPPPPPPPPPPPPPPPPP
PPPPPPPPPPPPPPPPPPPPPPPPPFPPPPFPPPPPPPPPPPPPPPPPPPPPPPPFPPPPPPPPFPPPPP
PPPPPPPFPPPPPPPPFFPPPFFPPPPPPPPPPPPPPPPPPPPPPPPPPPPFPPPPPPPPPFPPFPPPPP
PPPPPPPPPPPPPPPPPPPPPPPPPPPPPPPPPPPPPPPPPPPPPPPPPPPFFPPPPPPPPFPPPPPPPP
PPPPPPPPPPPPPPPPPPPPPPPFPPPPPPPPPFPPPPPPPPPPPPPPPPPPPPPPPPPPPPPPPPPPPP
FPPPPPPPPPPPPPPPPPPPPPPPPPPPPPPPPPPPPPPPPPPPPPPPPPPPPPPPPPPPPPFFPPPFFP
PPPPPPPFPPPPPPPPPPPPPPPPPPPPPPFPPFPPPPPPPPPPPPPFPPPPPPPPPPPPPPPPPPPPPP
PPPPPPPPPPFPPPFPPPPPFPPPPPPPPPPPFPPPPPPFPPPPPPPPPPPPPPPPPPPPPPPPPPPPPP
PPPPPPPPPPPPPPPPPPPPPPPPPPPPPPPPPPPPPPPPPPPPPPPFPPPPPPPPPPPPPPPPFPPFFF
PPPPPPPPPPPPPPPPPPPPPPPPPPPPPPPPPPPPPPPPPPPPPPPPPPPPPPPPPPPPPPPPPPPPPP
PPPPPPPPPPPPPPPPPPPPFPPPPPPPPPPPPPPPPPPPPPPPPPPFPPPPPPPPPPPPPPFFFPPPFP
PPPPPPPPPPPPPPPPFPPPPPPPPPPPPPPPPPPPFFPPPPFPPPPPPPPPPPPPPPPPPPPPPPPPPP
PFFPPPPPPPPPPPPPPPPPPPPPPPFPPPPPPPPPPPFPPPPPPPPPPPPPPPPPPPPPPPPPPPPPPP
PPPPPPPPPPPPPPPPPPPPPPPPPFPPPPPPPPPPPPPPPPPPPPPPFFPPPPPPPPPPPPPPFFPPPP
PPPPPPPPPPPPPPPPPPPPPPPPPPPPPPPPPPPFFPPPPPPPPPPPPPPFFPPPPPPPPPPPPPPPPP
PPPPPPPPPPPPPPPPPPPPPPPPPPPPPPPPPPPPPPPPPPPPPPPPPPPPPPPPPPPPPPPFPPPPPP
PPPPPPPPPPPPPPPPPPPPPPPPPPPPPPPFPPPPPPPPPPPPPPPPPPPPPPPPPPPPPPPPPPPPPP
PFPPPPPPPPPPPPPPPPPPPPPPPPPPPPPPPPPPPPPPPPPPPPPPPPPPPPPPPPPPPPPPPPPPPP
PPPPPFPPPPPPPPPPPPPPPPPPPPPPFPPPPPPPPPPPPPPPPPPFPPFFPPPPPPPPPPPPPPPPPP
PPPPPFFPFPPPPPPPPPPPPPPPPPPPPPPPPPPPPPPPPPPPPPPPPPPPPPPPPPPPPPPPPPPPPP
PPPPPPPPPPPPPPPPPPPPPPPPPPPPPPPPPPPPPPPPPPPPPPPPPPPPPPPPPPPPPPPPPPPPPP
PPPPPPPPPPPPPPPPPPPPPPPPPPPPPFFPPPPPFPPPPPFPPPPPPPPPPPPFPPPPPPFFPPPPPP
PPPPPPPPPPPPPPPPPPPPPPPPPPPPPPPPPPPPFPPPPPPPPPPPPPPPPPPPPPPPPPPPPPPPPP
PPPFPPPPPPPPPPPPPPPPPPPPPPPPFPFFPPPFPPPPFPPPPPPPPPPPPPPPPPPPFPPPPPPPPP
PPPFPPPPFPPPPPPPPPPPPPPPPPPPPPPPPPPPPPPPPPPPPPPPPPPPPPPPPPPPPPPPPFFFPP
PPPPPPPPPPPPPPPPPPPPPPPPPPPPPPPPPPPPPPPPPPPPPPPFPPPPPPPPPPPPPPPPPPPPPP
PPPPPPPPPPPPPPPPPPPPPPPPPPPPPPPPPPPPPPPPPPPPPPPPPPPPFPPPPPPPPPPPPPPPPP
PPPPPPPPPPPPPPPPPPPPPPPPPPPPPPPPPPPPPFPPPPPPPPPPPPPPPPPPPPPPPPPPPPPPPP
PPPPPPPPPPPPPFPPPFPPPPPPPPPPPPPPPPPPFPFFPPPPPPPPPPFPFPPFPFFPPPPPPPPFPP
PPPFPPPPPPPPPFPPPPPPPPPPPPPPPPPPPPPPPPPFPPPPPPPPPPPPPFPPPPFPPPPPPPFPPP
PPPPPPFPPPPPPPPPPPPPPPPPPPPPPPPPPPPPPPPPPPPPPPPPPPFPFPPPPPPPPPPPPPPPPP
PFPPPPPPPPPPPPPPPPPPPPPPPPPPPPPPPPFPPPPPFPPFPFPPFPPPPPPPPPPPPPPPPPPPPF
PPPPPPFPPPPPPPPPPFPPPPPPPPPPPPPPPPPPPPPPPPPPPPPPPPPPPFFPPPPPPFFPPPPPPP
PPPPPPPPFPPPPPPPPPPPPPFPPPPPPPPPPPPPPPPPPPPPPPPPPPPFPPPPPPPPPPPPPPPPPP
PPPPPPPPPPPPPPPPPPPPPPPPPPPPFPPPPPPPPPPPPPPPPPPPPPPPPFPPPPPPPPPPPFPPPP
PPPPPPPPPPPPPPPPPPPPPPPFPFPPPPPPPPPPPPPFPPPPPPPPPPPPPPFFPPPPPFPPPPPPPP
PPPPPPPPPPPPPPPPPPPPPPPPPPPPPFPPPPPPPPPPPPPPPPPPPPPPPPPPPPPPPPPPPPPPPP
PPPPPPPPPPPPPPPPPPPPPPPPPPPPPPPPPPPPPFPPPPPPPPPPPPPPPPPPPPPFPPPPPPPPPP
PPPPPPPPPPPFPPPPPPPPPPPPPPPPPPPPPPPPPPPPPPPPPPPPPPFPPPPPPPPPPPPPPPPPPP
PPPPPPPPPPPPPPPPPPPPPPPPPPPPPPPPPPPPPPPPPPPPPPPPPFFPPPPPPPPPPPPFFPPPPP
PPPPPPPPPPPPPPPPPPPPPPPPPPPPPPPPPPPPPFFPPPPPPPPPPPPPPPPPPPPPPPPPPPPPFF
PPPPPPPPPPPPPPPPPPPPPPPPPPPPPPPPPPPPPPPPPPPPPPPPPPPPPPPPPPPPPPPPPPPPPP
PPPPPPPPPPPPPFPPPPPFPFPPPPPPPPPPFPPPPPPFPPPPPPPPPPPPFPPPPPPPPPPPPPPPFF
PPPPPPPPPPPPFPPPPFPPPPPPPPPPPPPPPPPPPPPPPFFPPPPPPPPPPPPPFPPPPPPPPPPPPP
PPPPPPPPPPPPPPPPPPPPPPPPPPPFFPPPPPPPPPPPPPPPPPPPPPPPPPPPPPPPPPPPPPPPPP
PPPPPPPPPPPPPPPPPPPPPPPPPPPPPPPPPPPPPPPPPPPPPPPPPPPPPPPPFPPPPPPPPPPPPP
PPPPPPFPPPPPPPPPPPPPPPPPPPPPPPFFPPPPPPPPPPPPPPPPPPPPPPPFPPPPPPPPPPPPPP
PPPPPPPPPFFPFFPPPPPPPPPPPPPPPPPPFPPPPPPPPPPPPPPFPPPPPPPPPPPPPPFPPPFPPP
PPPPPPPPPPPPPPPPPPPPPPPPPPPPPPPPPPPPPPPPPPPPPPPPPPPPPPPPPPPPPPPPPFPFPP
PPPPPPPPPPPFFPPPPPPPPPPPFPPPFFPPPPPPPPPPPPPPFPPPPPPPPPFPPPPPPPFFPPFPPP
5A03JGN00-ATM4614P21QA2201
3
4229
321
70
65
PPPPPPPPPPPPPPPPPPPPPPPPPPPPPPPPPPPPPPPPPPPPPPPPPPPPPPPPPPPPPPPPPPPPPP
PPPPPPPPFPPFPPPPPPPPPPPPPPPPPPPPPPPPPPPPPPPPPPPFPPPPPPPPPPPPPPPPPPPPPP
PPPPPPPFPPPPPPFFPPPPPPPPPPPPPPPPPPPPPPPPPPPPPPPPPPPPPPPPPPPPPPPPPPPPPP
PPPPPPPPPPPPFFPPPPPPPPPPPPPPPPPPPPPPPPPFPPPPPPPPPPPPPPPPPPPPPPPPPPPPPP
PPPPPPPPPPPPPPPPPPPPPPPPPPPPPPPPPPPPPPPPPPPPPPPFFPPFPFPPPPPPFPPPPPPPPP
PPPPPPPPPPFPFPPPPPPPPPPPPPPPPPPFPPPPPPPPPPPPPPPPPPPPPPPPPPPPPPPPFPPPPP
PPPPPPPFPPPPPPPPPPPPPPPPPPPPPPPPPPPPPPPPPPPPPPPPPPPPPPPPFPPPPPPPPPPPPP
PPPPPPPPPPPPPPPPPPFPPPPPPPPPPPPPPPPPPPPPPPPPPPPPPPPPPPPPPPPPPFPPPPPPPP
PPPPPPPPPPPPPPPPPPPPPPPPPPPPFPPPPPPPPPPPPPPPPPPPPPPPPPPPPPPPPPPPPPPPPP
PPPPPPPPPPPPPFFPFPPPPPPPPPPPPPPPPFPPPPPPPPPPPPPPPPPPPPPPPPPPPPPPPPPPPP
PPPPPPPPPPPPPPPPPPPPPPPPPPPPPPPPPPPPPPPPPPPPPPPPPPPPPPPPPPPPPPPPPPPPFF
PPPPPPPPPFPPPPPPPPPPPPPPPPPPPPPPPPPPPPPPPPPPPPPPPPPPPPPPPFPPPPPPPPPPPP
PPPPPPPPPPPPPPPPPPFFPPPPPPPPPFPPPPPPPPPPPPPPPPPPPPPPPPPPPPPPPPPPPPPFFP
PPPPPPPPFPPPPPPPPPPPFPPPFPPPPPPPPPPPPPPPPPPPPPPPPPPPPPPPPPFPPPPPPPPPPP
FPPPPPPPPPFFPPPPPPPPFFFPPPPPPPPPPPPPPPPPPFPPFPPPPPPPPPPPPPPPPPPPPPPPPP
FPPPPPPPPPPPPPPPPPPPPFPPPPFFPPPPPPPPPPPPPPPPPPPPPPPPPPPPPPPPFFPPPFFPFF
PPPPPPPPPPPPPPPPPPPFFPPPPPPPPPPPPPPPFPPPPPFPPFPPPPPPPFPPPPPPPFPPPPPPPP
PPPFFPFPPPPFPPPPPPPPPPPPPPPPPPPFPPPPPFPPPPPPPFFPPPPPPPPPPPPPPPPPPPPPPF
PPPPPPPPPPPPFPPPPPPPPPPPPPPPFPPPPPPPPPPPPPPPPPPPPPPPPPPFPPPPPPPPPPPPPP
PPPPPPPPPPPPPPPPPPPPPPPPPPPPPPPFPPPPPPPPPPPPPPPPPPPPPPPPPPFPPPPPFPPPPF
PPPPPPPPPPPPPPFPPPPPPPPPPFPPPPPPPPPPPPPPPPPPPPPPPPPPPPPPPPFPPPPPPPFPPP
PPPPPPPPPPPPPPPPFFPFPFFPPPPPPPPPPPPPPPPPPPFFPPPPPPPPPPPPPPPPPPPPPPPPFF
FPPPPPPPPPPFPPPPPPFPPFFPPPPFFPPPPPPPPPPPPPPPPPPPPPPPPPPPPPPPPPPPPPPPPP
PPPPPPPPFPPPPFPFPPPPPPPPPPPPPPPFFPPPPPPPPPPPFPPPPPPPPPFFFFPPPPPPPPPPPP
PPPPPPPPFPPPPPPPPPPPPPPPPPPPPPPPPFFPPPPPPFFPPPPPPPPPPPPFFPPPPPPPPPPPPP
PPPPPPPPPPPPPPPPPPPPPPPPPFFPPPPPPPPPPPPPPPPPPPPPPPPFFPPPPPPPFPPPPPPPPP
PPPPPPPPPPFPPPPPPPPPPPPPPPPFPPPPPPPPPPPPPPPPPPPPPPPPPPPPPPPPPPPPPPPFPF
PPPPPPPPPPPPPPPPPPPPPFPPPPPPPPPPPPPPPPPPPPPPPPPPPPPFFPPPPPPPPPPPPPPPPP
PPPPPPPPPPPPPPPPPFPPPPPPPPPPPPFPPPPPPPPPPPPPPPPPPPPPPPPPFPPPPPPPPPPPPP
PPPPPPPPPPPPPPPPPPPPPFPPPPPPPPPPPPPPPPPPPPPPPPPPPPPPPPPPPPPPPPPPPPPPPP
PPPPPPPPFPPPPPPPPPPPPPPPPPPPPPPPPPPPPPPPPPPPPPPPPPPPPFPPPPPPPPPPPPPPPP
PPPPPPPPPPPPPPPPPPPPPPPPPPPPPPPPPPPPPPPPPPPPPPPPPPPPPPPPPPPPPPPPPPPPPP
PPPPPPPPPPPPPPPPPPPPPPPFPPPPPPPPPPPPPPPPPPPPPPPPPPPPPPPPPPPPPPPPPPPPPP
PPPPPPPPPFPPPPPFPPPPPPPPPPPPPPPPPPPPPPPPPPPPPPPPPPPFPPPPPPPFFPPPPPPPPP
PPPPPPPPPPPPPFFPPPPPPPPPPPPPFPPPPPPPPPPPPPPFPPPPPPPPPPPPPPPPPPPPPPPPPP
PPPPPPPPPPPPPPPPPPPPPPPPPPPPPPPPPPFPPPPPPPPPPPPPPPPPPPPPPPPPFPPPPPPPPP
PPPPPPPPPPPPPPPPPPPPPPPPPPPPPPPPPPPPPPPPPPPPPPPPPPPPPPPPPPPPPPPPPPPPPP
PFFPPPPPPFPPPPPPPPPPPFPPPPPPPPPPPFPPPFPPPPPPPPPPPPPPPPPPPPPPPPPFPPPPPF
PPPPPPPPPPPPPPFFPPPPPPPPPPPPPPPPPPPPPPPPPPPPPPPPPPPPPPPPPFFPPPPPPPPPPP
PPPPPPPPPPPPPPPPPPPPPPPPPPPFPPPPPPPPPPPPPPPPPPPPPPPPPPPPPFPPPPPPPFPPPP
PPPPPPPFPPPPPPPPPFPPPPPPPPPPPPPPFFPPPPPFPPPPPPPPPPPPPPPPPPPPPPPPPPFPPP
PPPPPPFFPPPPPPPPPPPFPPPPPPPPPPPPPPPPPPPPPPPPPPPPFPPPPPPPPPPPPPPPPPPPPP
PPPPPPPPPPPPPPPPPPPPPPPPPPPPPPPPPPPPPPPPFFPPPPFFFFPPPPPPPPPPPPFFPPPPPP
PPPPPPPPPPPPPPPPFFPPPPPPPPPPPFFPPPPPPPPPPPPPPPPPPPPFFPPPPPPPPPFPPPPPPP
PPPPPPPPPPPPPPPPPPFPPPFPPPPPFPPPPPPFPPPFPPPFFPPPFFPPPPPPPPPPPPPPPPPPPP
PPPPPPPPPFPPPPPPPPPPPPFFPPPPPPPPPFPPPPPPPPPPPPPPPPPPFPPPPPPPFPFPPPPPPP
PPPPPPPPPPPPPFFFFPPPPPPPPPPPPPPPPPPPPPPFPPPFFPPPPPPPPPPPPPPPPPFFPPPPPP
PPPPPFPFPPPPPPPPPPPPPPFPPPPPPFPPPPPPPPPPPPPPPPPPPPPPPPPPPPPPPPPPPPPPPP
PPPPPPPPPPPPPPPPPPPPPPPPPPPPPPPPFFPPPPPPPPPPPPPPPPPPPPPPPPPPPPPPPPPPPP
PPPPPPFPPPPPPPPPPPPPPPPPPPPPPPPPPPPPPFPPPPPPPPPPPPPPPPPPPPPPPPPPPPPPPP
PFPPPPPPPPF*FPPP*FPPPPPPFPPPPPPPPPPPPPPPPFPPPPPFPPPPPPPPPPPPPPPPPPPPPP
FPPPPPFPPPPPPPFFPPPPPPPPPPPPFPPPPFFPPFPPPPPPPPPPPPFPPFPFPPPPPPPPPPPPPP
PPPPPPPPPPPPPPPPPPPPPPPPPPPPPPPPFPPPPPPPPPFFPPPPPPPFPPPPPPPPPPPPPPPPPP
PPPPPPPPPPPPPPPPPPPPPPPPPPPPPPPPPPPPPPPPPPPPPPPPFPPPPPPPPPPFPPPPPPPPPP
FPPPPPPPPFPPPPPFFPPPPPPPPPPPPPPFPPPPFFFPPPPPPPPPPPPPPPPPPPPPPPPPPPPPPP
PPPPPPPPPPPPPPPPPPPPPPPPPPPPPPPFFFPPPPFFPPPFFFPPPPPPPPPFPPPPPPPPPPPPPP
PPPPPFPPPPPPPPPPPPPPPPFPPPPPPPPPPPPFFPPPPPPPPPPFPPPPPPFFPPPPPPPPPPPPPP
PFPPPPPPPPPPPPPPPPPPPPPPFPPPPPFFPPPPPFPPPFPPPPPPPPPPPPPPPPFFFPPPPPPPFP
PPPPPPPPPPPPPFPPPPPFPPPPPPPPPPPPPPPPFPPPPPPPPPPPPPPPPPPPPPPPPPPPPPPPPP
PPPPPPPPPPPPPPPPPPFPPPPPPPPPPPPPPPPFPPPPPPPPPFPPPPPPPPFPPPPFPPPPPPPPPF
PPPPPPPPPPPPPPPPPPPPPFPPPPPPPPPPPPPPPPPPPPPPPPPPPPPPPFPPPPPPPPPPPPPFPP
PPPPPFFPPPPFPPFFPPPPPPPPPFPPPPPPPPPPPPPPPPPPPPPPPPFPPPPPFPPPPPPPPFFPPP
PPPPPPPPPPPPPPFPPPPPPPPPPPPPPPPPPPPPPPPPPPPPPPPPPPPPPPPPPPPPPPPPPPPPPP
PPPFPPPPPPPPPFFPPPPFPPPPPPPPPPPPPPPPPPPPPPPPPPPPPPPPPPPFFPPPPPPFPPPPPP
PPPPPPPPPPPPPPPFFPFFPPPFFPPPPPPPPPPPPPPPPPPFFPFPPPPFPPPPPPPPPPPPPPPPPP
5A03JGN00-ATM4614P21QA2201
4
4308
242
70
65
PPPPPPPPPPPPPPPPPPPPPPPPPPPPPPPPPPPPPPPPPPPPPPPPPPPPPPPPPPPPPPPPPPPPPP
PPPPPPPPPPFPPPPPPPPPPPPPPPPPPPPPPFPPPPPPPPPPPPPPPPPPPPPPPPPPFPPPPPPPPP
PPPPPPPPPPFPPPPPFFFPPPPPPPPPPFPPFPPPPPPPPPPPPPPPPPPPPPPPPPPPFFPPPPPPPP
PPPPPPPPPFPPFPFPPPPPPPPPPPPPPPPPPPPPPPPPPPPPPPPPPPPPPPPPPPPPPPPPPPPPPP
FFPPPPPPPPPPFFPPPPFPPPPPPPPPPFPPPPPFFPPPPPPPPPPPPPPPPPPPPPPPPPPPPPPPPP
PPPPPPPPPPPPPPPPPPPPPPPFPPPPPPPPPFFPPPPPPPPPFPPPPPPPPPPPFPPPPPPFFPPPPP
PPPPPPPPPPPPPPPPPPPPPPPPFFPPPPPPFFPPPPPPPPPPPPPPPPPPPPPPPPPPPPPPPPPPPP
PPPPPPPPPPFPPPPPPPPPPPPPPPPPFPPPPPPPPPPPPFFPFFFFPPPFFFFFPPPPPFFPPPPPPF
PPPPPPPPPPPPFFPPPPPPPPPPPPPPPPPPPPPPPPPPPPPPFFPPPPPPPPPPPPPPPPPPPPPPPP
PPPPPPPPPPPPPPPPPPPPPPPPPPPPPPPPPPPPPPPPPPPPPPPPPPPPPPPPPPPPPPPPPPPPPP
PPPPPPPPPPPPPPPPPPPPPPPPPPPPPPPPPPPPPPPPPFFPPPPPPPPPPPPPPPPPPPPPPPPPPP
FFPPPPPPPPPPPPPPPPPPPPPPPPPPPPPPPPPPPFFFPPPPPPPPPPPPPPPPPPPPPPPPPPPPPP
PPPPPPPPPPPPPPPPPPPPPPPPPPPPPPPPPPPPPPPPPPPPPPPPPPPPPPPPPPPPPPPPPPPPPP
PPPPPPPPPPPPPPPPPPPPPPPPPPPPPFPPFFPPPPPPPPPPPPPFFPPPFPPPPPPPPPPPPPPPPP
PPPPPPPPPPPPPPPPPPPPPPPPPPPPPPPPPPPPPPPPPPPPPPPPPPPPFPPPPPPPPPPPPPPPPP
PPPPPPPPPPPPPPPPPPPPPPPPPPPPPFPPPPPPPPPPPPPPPPPPPPPPPPPPPPPPPPPPPPPPPP
PFPPPPPPPFPPPPPPPPPPPPPPPPPPPPPPPPPPPPPPPPPPPPPPPPPPPPPPPPPPPPPPPPPPPP
PPPPPPPPPPPPPPPPPPPPPFFPPPPPPPPPPPPPPPPPPPPPPPPFPPPPPPPPPPPPPPPPFFPPPP
PPFPPPPPPFPPPPPPPPPPPPPPPPPPPPPPPPPFPPPPPFFPPPPPPPFPPPPPPFPPPPPPPPPPPP
FPPPPPPPPPPPPPPPPPPPPPPFPPPPPPPPPPPPPPPPPPPPPPPPPPPPPPPPPPPPPFPPPPPPPP
PPPPPPPPPPPPPPPPPPPPPPPFPPPPPPPPPPPPPPPPPPPFPPPPPPPPPPPPPPPPPPPPPPPPPP
PPPPPPPPPPPPPPPPPPPPPPPPPPPPPPPPPPPPPPPPPPPFFPPPPPPPPPPPPPPPPPPPPPFFPP
PPFPPPPPPFFPPPPPFFPPPPPPPPPPPPPPPPPPPPPPPPPFPPPPPPPPPPPPPPPPPPPPPPPPPP
PPPPPPPPPPPPPPPPPPFPPPPPPPPPPPPPPPPPFFPPPPPPPPPPPPFPPPPFPPPPPPPPPPPPFP
PPPPPPPPPPPPPFPPPPPFPPPPPPPPPPPPPPPPPPPPFPPPPPPPPPFPPPPPPPPPPPPPPPPPPP
PPPPPPPPPPPPPPPPPPPPPPPPPPPFFPPPPPPPPPPPPPPPPPPPPPPPPPPFPPPPPPPPPPPPPF
PPPPFPPPPPPPPPPPPPPPPPPPPPPPPPPPPPPPPPPPPPPPPPPPPPPPPPPPPPPPPPPPPPPPPP
PPPPPPPPPPPPPPPPPPPPFPPPPPPPPPPPPPPPPPPPPPPPPPPPPPFPPPPPPPPPPPPPPPPPPF
PPPPPPPPPPPPPPPPPPPPPPPFPPPPPPPPPPPPPPPPPPPPPPPPPPPPPPPPPPPPPPPPPPPPPP
PPPPPPPPPPPPPPPPFPPPPPPPPPPPPPPPPPPPFPPPPPPPPPPPPPPPPPPPPPPPPPPPPPPPPP
PPPPPPPPPPPPPPPPPPPPPPPPPPPPPPPPPPPPPPPPPPPPPPPPPPPPPPPPPPPPPPPPPPFFPF
PPPPPPPPPPPPPPPPPPPPPPPPPPPPPPPPPPPPPPPPPFFPPPPPPPPPPPPPPPPFPPPPPPPPPP
PPPPPPPPPPPPPPPPPPPPPPPPPPFFPPPPPPPPPPPPPPPPPPPPPPPPPPPPPPPPPPPPPPPFPP
PPPPPPPPPFPPPPPPPPPPPPPPPPPPPPPPPPPPPPPPPPPPFPPPPPPPPPPPFFPPPPPPPPPFPP
PPPFPPPPPPPPPPPPPPPPPPPPFPPPPFFPPFPPFPPPFPPPPPPPPPPPPPPPPPPPPPPFPPPPPP
PPPPPPPPPPPPPPPPPPPPPPPPPPPPPPPPPPPFPPPPPPPPPPPFPPPPPPPPPPPPPPPPPPPPPP
PPPPPPPPPPPFPFPPPPPPFFPPPPPPPPPPFPPPFPPPPPPPPPFPPPPPFPPPPFPPPPPPPPPFFP
PPPPPPPPPPPPPPPPFPPPPPPPPPPPPPPPPPPFFPPPPPPPPPPPPPPPPFFPPPPPPPPFPPPPFP
PPPPPFPPPPPPPPPPPPPPPPPPFPPPPPPPPPPPPPPPPPPPFPPPPPPFPPPFPPPPPPPPPPPPPP
FPPPPPPPPPPPPPPPPPPPPPPPPPPPPPPPPPPFPPPPPPPFPPPPPPPPPPPPPPPPPPPPPFPFFP
PPPPPPPPPPPPPPPPPPPPPPPPFPPPPPPPPPPPPPPPPPPPPPPPPPPPPPPPPPPPPPPPPPPPPP
PPPPPPPPPPPPPPPPPPPFFFPPPPPPPPPPPPPPPPPFPPPPPPPPPPPPFFPPPPPPPFFPPPPPPP
FPPPPPPPPPPPPPPPPPPPPPPPPPPPPFPPPPFPPPPPPPPPPPPPPPPPPPPPPPPPPPPPPPPPFP
FPPPPPPPPPPPPPPPPPPPPPPPPPFPPPPPPPPPPPPPFFPPPPPPPPPPPPPPPPPPPPPPPFPPPP
PPPPPPPPFFPPPPPPPPPPPPPPPPPPPPPPPPPPPPPPPPPPPPPPPPPPPPPPPPPPPPPPPPPPPP
PPPPPPPPPPPPPPPPPPPPPPPPPPPPPPPPPPPPPPPPPPPPPPPPPPPPPPPPPPPPPPPPPPPFFP
PPPPPPPPPPPPPPPPPPPPPPPPPPPPPPPPPPPPPPPPPPPPPPPPPPPPPPPPPPPPPPPPPPPPPP
PPPPPPPPPPPPPPFPPPPPPPPPPPPPPPPPPPPPPPPPPPPPPPPPPPPFPPPFPPPPPPPPPPPPPP
PPPPPPPPPFPPPPPPPPPPPPPPPPFPPPPPPPPPPPPPPPPPPPPPPPPPPPPPPPPPPPPPPPPPPP
PPPPPPPFPPPPPPPPPPPPPPPPPPPPPPPPPPPPPPPPPPPPPPPPPPPPPPPPPPPPPFPPPPPPPP
PPPPPPPPPPPPPPPPPPPPFPPPPPPPPPPPPPPPPPFFPPPPPPPPPPPPPPPPPPPFFPPPPPPPPP
PPPPPFPPPPPFPPPPPPPPPPPPFPPPPPPPPPPPPPPPPPPPPPPPPPPPPPPPPPPPPPPPPPPPPP
PPPPPPPPPPPPPPPPPFPFPFPPPPPPPPPPPPPPPPPPPFPPPPPPPPPPPPPPPPPPPPPPPPPFPP
PPPPPPPPPPPPPPPPPPPPPPPPPPPPPPPFPPFPPPPPPPPPPFPPPPPPPPPPPPPPPPPPFPPPPP
PPPPPFPPPPPPPPPPPPPPPPPPPPPFPPPPPPPPPPPPPPPPPPPPPPPPPPPPPPPPPPPPPPPPPP
PPPPPPPPPPPPPPPPPPPPPPPPPPPPPPPPPPPPPPPPPPPPPPFPPPPPPFPPPPPPPPPPPPPPPP
PPPPPPPPPPPPPPPPPPPFFPPPPPPPPPPPPPPPPPPPPPPPPPPPPPPPPPPPPPPPPPPPPPPPPP
PFPPPPPPPPPPPPPPPPPFPPPPPPPPPPPPPPPPPPPPPPPPPPPPPPPPPPPPPPPPPPPPPPPFPP
PPPPPPPPPPPPPPPPPPPPPPPPPPPPPPPPPPPPPPPPPPPFFPPPPPPPPPPPPPPPPFFFPPPPPP
PPPPPPPPPPPPPPPPPPPPPPPPPPPPPPPPPPPPPPPPPPPPPPPPPPPPPPFPPPPPPPPPPPPPPP
PFPPPPPPPPPPPPPPPFPPPPPPPPPPPPPPPPPPPPFPPPPPPPPPPPPPPPPPPPPPPPPPPPPPPP
PPPPPPPPPPPPPPPPPPPPPPPPPPPPPPPPPPPPPPPPPPPPPPPPPPPPPPPFPPPPPPPPPPPPPP
PPPPPPPPPPPPPPPPPPPPPPPPPPPPPPPPPPPPPPPPPPPPPPPPPPPPPPPPPPPPPPPPPPPPPF
PPPPPPPPPPPPPPPPPFFPPPPPPPPPPPPPPPPPPPPPPPPPPPPPPPPPPPPPPPPPPPPPPPPPPP
PPPPPPPPPPPPPPPPPPPPPPPPPPPPPFPPPPPPPPPPPPPPPPFPPPPPPPPPPPPFPPPPPPPPPP
